select fundtypename, count(*) from mf_fundreturnrank where indexcycle = '一个月' and fundreturn > 0 group by fundtypename	ccks_fund	显示指标周期为"一个月"的基金收益为正的基金数目，按基金类别分组展示
select b.secuabbr,b.investorientation from mf_benchmarkgrowthrate as a join mf_fundarchives as b on a.innercode=b.innercode   where a.benchgrforthisweek>0;	ccks_fund	列出本周以来基金基准增长幅度为正的基金和投资方向 谢谢啊
select shname from lc_largeshsubscription  where strftime('%Y', initialinfopubldate)='2017' group by  shname order by max(actualshares) desc limit 1;	ccks_stock	2017年配股最多的大股东
select shname from lc_largeshsubscription where actualshares>500000 and oughtshares>500000;	ccks_stock	哪些股东名称的实配和应配股数都超过50万
select a.chinameabbr, a.leadername, a.positiondescription from lc_executivesholdings as a join lc_sharetransfer as b on a.companycode = b.companycode order by b.pctbeforetran desc limit 5	ccks_stock	出让前持股占比排名前5公司的公司名称、高管姓名及职位
select proportiongrhalfayear from lc_shnumber where chinameabbr='兴业证券';	ccks_stock	兴业证券的户均持股比重半年增长率是多少 谢谢啊
select grossprofit from lc_mainoperincome where chinameabbr ='西藏发展';	ccks_stock	西藏发展还能继续持有吗，帮我查一下这些年西藏发展的毛利
select a.chinameabbr, a.fpshname, a.accupctofpled from lc_sharefpsta as a join lc_exgindustry as b on a.companycode = b.companycode where b.firstindustryname = '房地产业'	ccks_stock	列出公司所属一级行业为"房地产业"的公司简称、冻结质押股东名称及累计占冻结质押方持股数比重 谢谢
select a.secuabbr from mf_fundmanagernew as a join mf_personalinfo as b on a.personalcode = b.personalcode where b.education = '本科'	ccks_fund	查一下最高学历为本科的基金经理管理过哪些基金？
select b.chinesename,b.education from mf_fmscaleanalysisn as a join mf_personalinfo as b on a.personalcode=b.personalcode where a.qdiinv>200;	ccks_fund	哪些基金经理的QDII管理规模超过了200亿？各自最高学历是什么
select chinameabbr from lc_stockarchives where generalmanager='孙健';	ccks_stock	我想了解一下数据情况。孙健是哪个公司的总裁
select fundmanager , fund from mf_awards where appraisalorg = '证券时报';	ccks_fund	"证券时报"给哪些经理管的什么基金颁发了奖项
select b.secuabbr,b.manager from mf_bondportifoliodetail as a join mf_fundarchives as b on a.innercode=b.innercode where a.bondabbr='兴业转债';	ccks_fund	看下哪个基金和经理持仓了兴业转债 谢谢啊
select chinameabbr, controllername from lc_actualcontroller where secucode like '00%';	ccks_stock	查出全部00开头的上市公司简称及相应实际控制人 谢谢啊
select b.chinesename, a.maxret from mf_fmperfanalysis as a join mf_personalinfo as b on a.personalcode = b.personalcode where b.education = '博士' and a.indexcycle = '一年';	ccks_fund	查询所有博士最高学历基金经理姓名及对应的一年期最大收益率
select b.secuabbr,b.manager from mf_bondportifoliodetail as a join mf_fundarchives as b on a.innercode=b.innercode group by b.secuabbr order by count(*) desc limit 10;	ccks_fund	找出持有债券种类最多的十个基金和经理
select b.chinameabbr,a.totalrdinput from lc_intassetsdetail as a join lc_stockarchives as b on a.companycode=b.companycode   where b.state='浙江省' and strftime('%Y', a.enddate)='2018';	ccks_stock	帮我找找数据，浙江省上市公司2018年每个公司的研发费用
select b.type, count(*) from mf_fundreturnrank as a join mf_fundarchives as b on a.innercode = b.innercode where a.indexcycle = '成立以来' and a.fundreturnmean > 0 group by b.type	ccks_fund	同学你好！显示指标周期为"成立以来"的同类基金收益率均值为正的基金数目，按基金运作形式分组展示
select a.fullname,b.shname from lc_issueandlistagent as a join lc_largeshsubscription as b on a.companycode=b.companycode where a.chinameabbr='天健集团';	ccks_stock	天健集团股票上市发行时的中介结构和配股股东名称
select count(*) from lc_mainoperincome where mainopercost < 100000000;	ccks_stock	siri, 历史上营业成本低于1亿元的公司多吗，有多少个
select a.secucode , b.secretarybd , b.secretarybdtel from lc_coconcept as a join lc_stockarchives as b on a.companycode = b.companycode where a.conceptname ='东数西算' ; 	ccks_stock	我想知道"东数西算"热门板块的股票情况，列出股票代码、董事长秘书名称和董秘电话
select investmenttype, avg(foundedsize) from mf_fundarchives group by investmenttype;	ccks_fund	同学你好！不同基金投资类型的设立规模均值分别是多少？
select chinameabbr from lc_actualcontroller where controllername = '赵马克';	ccks_stock	赵马克是哪个公司实际控制人名称
select turnoverdeals from qt_dailyquote where secucode = '601908';	ccks_stock	帮我查一下这些数据。展示601908每个交易日的交易量数据
select a.secuabbr , b.secretarybd , b.secretarybdtel from lc_coconcept as a join lc_stockarchives as b on a.companycode = b.companycode where a.conceptname ='3D玻璃' ; 	ccks_stock	帮我看一下"3D玻璃"板块的股票都有哪些，列出股票名称，董事会秘书名称和董事会秘书联系方式
select accumulatedunitnv , nvdailygrowthrate from  mf_netvalue ;	ccks_fund	列出各个基金的单位累计净值和开放式基金单位基金净值日增速记录
select distinct a.chinameabbr from lc_dividend as a join lc_stockarchives as b on a.companycode = b.companycode where strftime('%Y', b.establishmentdate)>'2010' ;	ccks_stock	成立日期在2010年以后的上市公司中（唯一化），有哪些实施过分红
select count(*) from mf_fundreturnrank where fundreturn < 0 and fundannreturn < 0	ccks_fund	帮我查一下，基金收益和基金年化收益率均小于0的基金有多少只 谢谢啊
select a.name from mf_fundmanagernew as a join mf_fundrisklevel as b on a.innercode = b.innercode where b.risklevel = '中低' group by a.name having count(a.secuabbr) > 5	ccks_fund	找到持有基金风险评级为"中低"的基金数目超过5只的基金经理名称
select secuabbr from mf_benchmarkgrowthrate where benchgrfor3year>0;	ccks_fund	找下三年基金基准增长幅度为正的基金
select chinameabbr, enddate from qt_monthdata where pb < 5 and pettm > 200; 	ccks_stock	哪些股票及月度时间满足市盈率大于200，且PB小于5，列出股票名称 谢谢
select count(*) from mf_fmretscaleanalysis as a join mf_personalinfo as b on a.personalcode = b.personalcode where a.totalaum > 100 and b.education = '本科'	ccks_fund	基金经理最高学历为"本科"且所管理的基金总规模超过100亿元的基金经理人数
select count(*) from lc_mainoperincome  where strftime('%Y', enddate)='2020' and grossprofit > 1	ccks_stock	2020年主营业务销售毛利率大于1的公司有多少个
select investadvisorabbrname from mf_investadvisoroutline where strftime('%Y', establishmentdate)>'2010';	ccks_fund	2010年以后成立的新基金管理人简称有哪些
select a.secuabbr , b.secretarybd from lc_coconcept as a join lc_stockarchives as b on a.companycode = b.companycode where a.conceptname ='大飞机' ; 	ccks_stock	你知道"大飞机"这个板块的股票董事会秘书都有哪些人吗，列出股票名称和董秘名称
select b.education from mf_fmperfanalysis as a join mf_personalinfo as b on a.personalcode = b.personalcode where a.annalphacoef > 0.2 group by b.education having count(*) > 5	ccks_fund	基金经理管理基金的年化阿尔法超过0.2，基金经理人数超过5的最高学历有哪些？
select investadvisorabbrname from mf_investadvisoroutline where legalrepr like '周%';	ccks_fund	查出那些企业法定代表姓周的基金管理人简称
select a.secuabbr from mf_fundrisklevel as a join mf_fundarchives as b on a.innercode = b.innercode where a.risklevel = '中低' and b.type = '开放式'	ccks_fund	你好，基金运作形式为"开放式"的基金风险程度为"中低"有哪些？
select b.chinesename,b.background from mf_fmscaleanalysisn as a join mf_personalinfo as b on a.personalcode=b.personalcode where a.equityfundn>5;	ccks_fund	快速找一下数据。给出管理股票型基金数量超过5个的基金经理和他们的简介
select mainoperincome , mainincomegrowrateyoy from lc_mainoperincome where mainincomegrowrateyoy > 0 and chinameabbr ='古井贡酒';	ccks_stock	列出上市以来古井贡酒营业收入同比大于0的记录，包含主营业务收入，营业收入同比增长率
select a.chinesename, b.education from mf_fmretscaleanalysis as a join mf_personalinfo as b on a.personalcode = b.personalcode where a.timeinterval = '今年以来' order by a.avgaum desc limit 3	ccks_fund	指标周期为"今年以来",基金平均规模排名前3的基金经理姓名和最高学历
select chiname from lc_mainoperincome  where strftime('%Y', enddate)='2020' and grossprofit > 1	ccks_stock	帮我查一下这些数据。2020年主营业务销售毛利率大于1的公司有哪些
select chinameabbr, bonusshareratio from lc_dividend where chinameabbr = '京基智农' or chinameabbr = '天健集团';	ccks_stock	京基智农、天健集团的送股占比分别是多少
select shname from lc_largeshsubscription where oughtshares>2000000;	ccks_stock	哥，有哪些配股大股东名称的应配股数超过2百万股
select shname,actualshares from lc_largeshsubscription where chinameabbr='同济科技';	ccks_stock	同学你好！同济科技的配股大股东名称有哪些，分别实际配股多少
select organizationform, count(*) from mf_investadvisoroutline group by organizationform order by count(*) asc;	ccks_fund	哥，帮我统计一下不同公司属性的基金管理人数量，并进行升序展示
select actualshares from lc_largeshsubscription where shname='杉杉集团';	ccks_stock	杉杉集团作为配股股东名称的实际配股记录
select investadvisorabbrname from mf_investadvisoroutline order by regcapital desc limit 1;	ccks_fund	帮我查一下这些数据。把注册资金最大的基金管理人简称找出来
select a.secuabbr from mf_fundrisklevel as a join mf_fundarchives as b on a.innercode = b.innercode where a.risklevel = '中低' and b.investmenttype= '成长型—稳健成长型'	ccks_fund	基金投资风格为"成长型—稳健成长型"基金的基金风险评级为"中低"的有哪些？
select chiname, shinvestsum from lc_relatedsh  where chinameabbr = '航天发展' and strftime('%Y', enddate)='2019' and strftime('%m', enddate )='5'	ccks_stock	查询2019年5月航天发展的股东及股东投资金额
select a.fullname,a.legalpersonrepr,b.shname,b.actualshares from lc_issueandlistagent as a join lc_largeshsubscription as b on a.companycode=b.companycode where a.chinameabbr='东阿阿胶';	ccks_stock	查询参与东阿阿胶股票发行的机构及其法人，以及配股大股东名称和实配股数
select avgholdsumgrhalfayear from lc_shnumber where chinameabbr='工商银行';	ccks_stock	请问工商银行的户均持股数半年增速是多少
select count(*) from mf_fundrisklevel as a join mf_fundarchives as b on a.innercode = b.innercode where a.risklevel = '中' and b.investmenttype= '综合型'	ccks_fund	统计一下，基金投资风格为"综合型"的基金里基金风险级别为"中"的有多少家？ 谢谢
select b.secuabbr,b.manager from mf_bondportifoliodetail as a join mf_fundarchives as b on a.innercode=b.innercode where a.bondabbr='21国债01' order by a.holdvolume desc limit 1;	ccks_fund	哥，持有21国债01张数最多的基金及经理
select state,city,astockcode from lc_stockarchives where chinameabbr='天娱数科';	ccks_stock	帮我找找数据，找出天娱数科所在省市及代码
select b.secuabbr,b.manager,b.riskreturncharacter from mf_benchmarkgrowthrate as a join mf_fundarchives as b on a.innercode=b.innercode order by a.benchgrforthisweek desc limit 10;	ccks_fund	有本周以来基金基准增长率排名前十的基金、基金经理和风险收益类型的信息吗
select secuabbr from mf_benchmarkgrowthrate where benchgrfor2year<0;	ccks_fund	列出两年基金基准增速为负的基金
select mainoperprofit, mainopercost from lc_mainoperincome  where strftime('%Y', enddate) = strftime('%Y', DATE('now', '-1 year')) and secucode ='000822';	ccks_stock	帮我看看000822前一年的主营业务利润和营业总成本
select investadvisorname from mf_fundarchives where trusteename='中信银行股份有限公司' group by investadvisorname order by count(*) desc limit 1;	ccks_fund	展示一下数据，被中信银行股份有限公司托管最多的基金管理人是哪个公司？
select mainincomegrowrateyoy from lc_mainoperincome where mainincomegrowrateyoy < 0 and secucode ='000822' and strftime('%Y', enddate)>'2020'	ccks_stock	哥，2020年以后，000822的营业收入同比有为负数的情况吗，列一下营业收入同比字段
select b.chinameabbr, a.generalmanager from lc_stockarchives as a join lc_freefloat as b on a.companycode = b.companycode where b.totalashare > 10000000000	ccks_stock	A股总股本超过100亿的公司名称和总裁
select unitnv , nvweeklygrowthrate from  mf_netvalue ;	ccks_fund	您好，请简要介绍下各个基金的单位净值和单位基金净值周增长幅度
select b.risklevel, count(a.secuabbr) from mf_fundmanagernew as a join mf_fundrisklevel as b on a.innercode = b.innercode where a.performance > 0 group by b.risklevel	ccks_fund	任职期间基金净值增速为正的基金经理，按基金风险级别来统计所管理的基金数目
select bondfundn,bondfundnv from mf_fmscaleanalysisn where chinesename='陈龙';	ccks_fund	列一下陈龙管理的债券型基金数目和规模 谢谢
select secuabbr from mf_benchmarkgrowthrate where benchgrforthisweek>5;	ccks_fund	有哪些基金的本周以来基金基准增长幅度超过5% 感谢
select proportiongrquarter from lc_shnumber  where strftime('%Y', enddate)='2020' and chinameabbr='金禾实业';	ccks_stock	2020年金禾实业的户均持股比例季度增速情况是怎样的
select a.secuabbr, a.riskreturncharacter from mf_fundarchives as a join mf_fundrisklevel as b on a.innercode = b.innercode where b.risklevel = '中'	ccks_fund	快速找一下数据。基金风险程度为"中"的基金名称和风险收益类型
select  secucode  from lc_mainoperincome  where strftime('%Y', enddate) > strftime('%Y', DATE('now', '-3 year')) and grossprofit >1;	ccks_stock	我朋友最近想买股票，帮我看看近三年利润贡献超过1的公司有哪些，列出股票代码
select secuabbr from mf_benchmarkgrowthrate where benchgrfor10year>200;	ccks_fund	有哪些基金的十年基金基准增速超过200%
select investadvisorname,count(*) from mf_fundarchives where fundtype='混合型' group by investadvisorname order by count(*) desc limit 1;	ccks_fund	哪个基金管理人管理的混合型股票最多？数量是多少？
select investadvisorabbrname from mf_investadvisoroutline where regcapital > 200000000 and strftime('%Y', establishmentdate)>'2015';	ccks_fund	成立日期在2015年以后且注册资金大于20亿的基金管理人简称有哪些
select count(*) from lc_sharefp where receivername ='中国进出口银行';	ccks_stock	作为股权质押方，中国进出口银行管理了几家公司的冻结质押股份
select legalrepr from mf_investadvisoroutline where investadvisorabbrname = '中银基金';	ccks_fund	帮我查一下中银基金的法定代表是谁
select mainbusiness from lc_business where chinameabbr ='深科技'	ccks_stock	嘿，深科技的核心业务是什么
select a.secucode, b.legalrepr , b.officeaddr from lc_coconcept as a join lc_stockarchives as b on a.companycode = b.companycode where a.conceptname ='边缘计算' ; 	ccks_stock	股市黑天鹅了，"边缘计算"板块的上市公司的法定代表和公司地址是哪里，同时写出上市公司代码
select chinameabbr,astockcode from lc_stockarchives where state='新疆维吾尔自治区';	ccks_stock	新疆的上市公司和它们的证券代码都是多少
select a.fullname,b.ashareabbr from lc_issueandlistagent as a join lc_stockarchives as b on a.companycode=b.companycode  where b.chinameabbr='武汉控股';	ccks_stock	武汉控股的公司全称是什么？及它股票发行上市的承销机构
select b.type, count(*) from mf_fundreturnrank as a join mf_fundarchives as b on a.innercode = b.innercode where a.indexcycle = '六个月' and a.fundreturnmean < 0 group by b.type	ccks_fund	显示指标周期为"六个月"的同类基金收益率均值为负的基金数目，按基金运作形式分组展示
select a.secuabbr from mf_fundrisklevel as a join mf_fundarchives as b on a.innercode = b.innercode where a.risklevel = '中高' and b.type = '开放式'	ccks_fund	基金运作形式为"开放式"的基金风险级别为"中高"有哪些？
select issuevolfloor, issuevolceiling from lc_ashareseasonednewissue where secucode = '002305';	ccks_stock	002305这支股票增发对应的最小发行量, 最大发行量
select secuabbr from mf_fundreturnrank where indexcycle = '六个月' order by fundreturn desc limit 1	ccks_fund	找出指标周期为"六个月"的基金收益最高的基金名称
select netinterestexpense from lc_financialexpense where strftime('%Y', enddate)<'2017' and chinameabbr = '八方股份';	ccks_stock	八方股份2017年以前的利息净支付是多少？
select chinameabbr, bonusshareratio from lc_dividend order by bonusshareratio desc limit 1;	ccks_stock	帮我查一下历史上单次送股占比最高的公司，以及当时的送股比重情况
select chinameabbr from lc_dividend order by bonusshareratio desc limit 1;	ccks_stock	送股比重最高的股票是哪只
select shname from lc_largeshsubscription where chinameabbr='广州浪奇';	ccks_stock	hello,广州浪奇的配股股东
select a.name, a.performance from mf_fundmanagernew as a join mf_fundarchives as b on a.innercode = b.innercode where b.secumarket = '上海期货交易所'	ccks_fund	证券市场为"上海期货交易所"的基金中，基金经理名称及基金增长率 谢谢
select chinameabbr, controllername from lc_actualcontroller where secucode like '6%';	ccks_stock	看一下股票代码以6开头的上市公司简称，及它们的实际控制人名称
select shname, holdingsum from lc_relatedsh where chinameabbr ='农发种业' and strftime('%Y', enddate)<'2019';	ccks_stock	嘿，帮我看一下2019年以前，农发种业有哪些大股东，持股数量分别是多少
select count(*)  from lc_mainoperincome  where strftime('%Y', enddate) > strftime('%Y', DATE('now', '-3 year')) and grossprofit >1;	ccks_stock	近三年毛利超过1的公司有多少个
select b.background from mf_fundmanagernew as a join mf_personalinfo as b on a.personalcode = b.personalcode where performance < 0 and managementtime > 200	ccks_fund	返回任职天数超过200天且任职期间基金增长率为负的基金经理简介
select a.chinesename, b.education, b.experiencetime from mf_fmretscaleanalysis as a join mf_personalinfo as b on a.personalcode = b.personalcode where a.weightedavgmonreturn > 0	ccks_fund	请问，月平均收益率为正的基金经理姓名，最高学历，证券从业经理年限 谢谢
select risklevel from mf_fundrisklevel where secuabbr = '国金50'	ccks_fund	国金50的风险程度是什么？
select investadvisorabbrname, establishmentdate from mf_investadvisoroutline where investadvisorabbrname = '大成基金' or investadvisorabbrname = '兴银基金';	ccks_fund	大成基金和兴银基金都是什么时候成立的呀 谢谢啊
select state,city,establishmentdate from lc_stockarchives where chinameabbr='同仁堂';	ccks_stock	我想了解一下数据情况。同仁堂所在省市及成立时间
select b.manager,a.marketvalue from mf_bondportifoliodetail as a join mf_fundarchives as b on a.innercode=b.innercode where a.bondabbr='博世转债';	ccks_fund	看下持仓了博世转债的经理以及持仓市值
select proportiongrquarter from lc_shnumber  where strftime('%Y', enddate)='2020' and round(strftime('%m',enddate)/3.0 + 0.495)=2 and chinameabbr='京基智农';	ccks_stock	京基智农2020年2季度的户均持股占比季度增长幅度
select chinameabbr from qt_monthdata  where pb < 1 and strftime('%Y', enddate) = strftime('%Y', date()) and strftime('%m', enddate)='1';	ccks_stock	哪些股票今年一月的市净率PB低于1 谢谢
select benchgrfor6month from mf_benchmarkgrowthrate where secuabbr='易方达中盘ETF';	ccks_fund	查下易方达中盘ETF的六个月基金基准增速
select b.chinesename,b.birthdate from mf_fmscaleanalysisn as a join mf_personalinfo as b on a.personalcode=b.personalcode order by a.bondfundnv desc limit 10;	ccks_fund	查下债券型管理规模排名前十的基金经理和生日信息 谢谢啊
select a.chinameabbr from lc_intassetsdetail as a join  lc_stockarchives as b on a.companycode=b.companycode  where strftime('%Y', a.enddate)=strftime('%Y', DATE('now', '-1 year')) and b.state='浙江省' and totalrdinput>100000000;	ccks_stock	浙江省内去年有哪些公司的研发费用超过1亿元 谢谢
select investadvisorname from mf_fundarchives where trusteename='北京银行股份有限公司';	ccks_fund	北京银行股份有限公司托管了哪些基金管理人的基金？
select secuabbr,manager from mf_fundarchives where investadvisorname='合煦智远基金管理有限公司' and fundtype='债券型';	ccks_fund	找一下合煦智远基金管理有限公司管理的债券型基金及经理信息
select b.secuabbr,b.manager from mf_benchmarkgrowthrate as a join mf_fundarchives as b on a.innercode=b.innercode order by a.benchgrfor1year desc limit 10	ccks_fund	一年基金基准增长率排名前十的基金和基金经理
select chiname,astockcode from lc_stockarchives where chinameabbr='德美化工';	ccks_stock	查下德美化工的全称和证券代码 感谢
select a.secuabbr,b.investfield from mf_benchmarkgrowthrate as a join mf_fundarchives as b on a.innercode=b.innercode   where a.dailybenchgr>0;	ccks_fund	本日基金基准增长幅度大于0的基金和基金投资范围
select count(*) from lc_sharesfloatingschedule where proportion1 < 20	ccks_stock	嘿，本次新增可售A股占上期末已流通A股比重小于20%有多少家
select secuabbr from mf_benchmarkgrowthrate order by benchgrfor3month desc limit 10;	ccks_fund	同学你好！挑选出10支三个月基金基准增速最高的基金
select a.chinesename, b.education from mf_fmretscaleanalysis as a join mf_personalinfo as b on a.personalcode = b.personalcode where a.avgaum < 20 and a.fundtypename = '股票型'	ccks_fund	找一下数据。基金类别为"股票型"，基金平均规模小于20亿元的基金经理姓名及最高学历
select proportiongrquarter from lc_shnumber  where strftime('%Y', enddate)='2020' and round(strftime('%m',enddate)/3.0 + 0.495)=4 and chinameabbr='京基智农';	ccks_stock	我想了解一下数据情况。京基智农2020年4季度的户均持股比重季度增速
select education, gender, count(*) from mf_personalinfo group by education, gender;	ccks_fund	计算一下不同最高学历，不同性别对应的基金经理数量
select investadvisorname,count(*) from mf_fundarchives where investstyle='行业股票-金融地产' group by investadvisorname;	ccks_fund	统计一下每个基金管理人管理了多少“行业股票-金融地产”
select shname, secucode from lc_relatedsh  where shinvestsum > 10000000 and strftime('%Y', enddate) > strftime('%Y', DATE('now', '-2 year')) ;	ccks_stock	这两年资本市场火爆，哪些股东名称的股东投资总额超过了1千万，列出这些大股东和股票代码
select a.secuabbr,a.dailybenchgr from mf_benchmarkgrowthrate as a join mf_fundarchives as b on a.innercode=b.innercode  where b.type='LOF';	ccks_fund	LOF型基金和本日基金基准增速 感谢
select chiname from lc_relatedsh  where strftime('%Y', enddate)='2010' and strftime('%m', enddate )='5' and shinvestsum > 100000000	ccks_stock	2010年5月股东投资总额达到100000000的公司有哪些
select shname from lc_largeshsubscription where secucode='000686';	ccks_stock	找一下数据。请列出000686的配股大股东名称
select b.secuabbr,b.manager from mf_bondportifoliodetail as a join mf_fundarchives as b on a.innercode=b.innercode where a.bondabbr='百润转债' order by a.marketvalue desc limit 1;	ccks_fund	展示一下数据，哪个基金持仓百润转债的市值最高，经理是谁？
select b.education from mf_fmperfanalysis as a join mf_personalinfo as b on a.personalcode = b.personalcode where a.annsortinor > 2 group by b.education having count(*) > 10	ccks_fund	基金经理管理基金的年化索提诺比率超过2，基金经理人数超过10的最高学历有哪些？
select a.totalaumtypeavg from mf_fmretandscalerank as a join mf_personalinfo as b on a.personalcode = b.personalcode where b.education = '本科'	ccks_fund	siri, 帮忙查一下，基金经理最高学历为本科的总管理规模同类均值
select chinameabbr from lc_shnumber where avgholdsumgrquarter>5;	ccks_stock	找一下数据。户均持股数季度增长幅度超过5%的公司
select mainbusiness , industryname from lc_business where chinameabbr ='浙大网新'	ccks_stock	我想了解浙大网新的主营构成和所属行业
select shname from lc_largeshsubscription where secucode='600165';	ccks_stock	我想了解一下数据情况。600165的配股大股东名称信息？
select a.name, a.performance from mf_fundmanagernew as a join mf_fundrisklevel as b on a.innercode = b.innercode where b.risklevel = '中高'	ccks_fund	找一下数据。基金风险程度为"中高"的基金对应的基金经理名称和任职期间基金净值增速
select bonusshareratio, cashdivirmb from lc_dividend where secucode ='000552';	ccks_stock	我很久之前买了000552，能帮我查一下它例是送股比重、派现金额吗
select b.type, count(*) from mf_netvalueperformancehis as a join mf_fundarchives as b on a.innercode = b.innercode where a.rrinsingleyear > 20 group by b.type;	ccks_fund	siri, 麻烦帮我统计一下不同基金运作形式各有几只基金产品一年回报率超过20%
select a.fullname,b.shname from lc_issueandlistagent as a join lc_largeshsubscription as b on a.companycode=b.companycode where a.chinameabbr='天健集团';	ccks_stock	哪些机构参与了天健集团的股票发行，还有它的配股股东都有谁
select secuabbr from mf_benchmarkgrowthrate where benchgrfor7year>200;	ccks_fund	你好，看看七年基金基准增速超过200%的基金有哪些
select b.secuabbr,b.manager,a.benchgrfor6month from mf_benchmarkgrowthrate as a join mf_fundarchives as b on a.innercode=b.innercode where a.benchgrfor6month>0;	ccks_fund	列出六个月基金基准增速为正的基金、基金经理和具体值
select count(*) from lc_mainoperincome where chinameabbr='中国石化' and mainoperincome > 200000000000 ;	ccks_stock	计算出中石化总共有几年的营收超过2000亿
select count(*) from lc_relatedsh  where strftime('%Y', enddate)='2020' and strftime('%m', enddate )='3' and shinvestsum > 100000000	ccks_stock	我想知道2020年3月股东投资总额达到100000000的公司有多少
select count(*) from mf_fundarchives  where strftime('%Y', startdate)='2021' and strftime('%m', startdate)='5' and fundtype='基础设施证券投资基金';	ccks_fund	列一下一共有多少基础设施证券投资基金基金的存续期开始日在2021年5月份
select b.manager,b.investadvisorname,a.equityfundnv from mf_fmscaleanalysisn as a join mf_fundarchives as b on a.chinesename=b.manager where a.equityfundnv>50;	ccks_fund	给出股票型管理规模超过50亿的经理、基金管理人和市值信息
select b.secuabbr,b.manager,b.profitdistributionrule from mf_benchmarkgrowthrate as a join mf_fundarchives as b on a.innercode=b.innercode order by a.weeklybenchgr desc limit 10;	ccks_fund	同学你好！给我看一下一周基金基准增长率排名最高的十个基金、基金经理和收益分配原则信息
select investadvisorname,count(*) from mf_fundarchives where fundnature='QDII基金' and investmenttype='优化指数型' group by investadvisorname order by count(*) desc limit 1;	ccks_fund	QDII基金里，不同基金管理人管理的优化指数型基金数量
select b.secuabbr,b.investtarget from mf_benchmarkgrowthrate as a join mf_fundarchives as b on a.innercode=b.innercode   order by a.benchgrforthisweek desc limit 10;	ccks_fund	本周以来基金基准增长幅度最高的十支基金和其投资目标
select a.chinameabbr from lc_mainoperincome as a join lc_stockarchives as b on a.companycode = b.companycode  where b.state ='浙江省' and strftime('%Y', enddate)='2020' order by  a.mainopercost limit 1;	ccks_stock	2020年浙江省内成本费用最多的公司是哪家 谢谢啊
select secuabbr from mf_benchmarkgrowthrate order by benchgrforthisquarter desc limit 10;	ccks_fund	有哪些基金是本季度以来基金基准增长幅度最高的10支基金 谢谢啊
select b.chinesename,b.gender,b.education from mf_fmscaleanalysisn as a join mf_personalinfo as b on a.personalcode=b.personalcode where a.equityfundnv>100;	ccks_fund	有哪些基金经理的股票型管理规模超过100亿，性别和最高学历信息？
select chinameabbr, mainbusiness from lc_business where chinameabbr ='南华生物' or chinameabbr ='浙大网新'	ccks_stock	南华生物和浙大网新是主要经营业务是什么，帮我查一下 谢谢啊
select rrinselectedmonth, rrinsinglemonth from mf_netvalueperformancehis where secuabbr = '天弘恒享';	ccks_fund	帮我找找数据，基金产品名称为天弘恒享的本月以来及一个月以来回报率
select legalrepr,generalmanager from lc_stockarchives where astockcode='600135';	ccks_stock	有600135的法定责任人和总裁信息吗
select a.chinameabbr, a.city, a.generalmanager from lc_stockarchives as a join lc_exgindustry as b on a.companycode = b.companycode where b.firstindustryname = '制造业'	ccks_stock	显示一级行业为"制造业"公司的公司简称、城市和总经理
select chiname, chinameabbr from lc_buyback  where strftime('%Y', advancedate) > strftime('%Y', DATE('now', '-2 year'));	ccks_stock	统计下最近两年进行过股份回购的公司，列出公司全称和股票名称
select b.manager,b.investadvisorname from mf_bondportifoliodetail as a join mf_fundarchives as b on a.innercode=b.innercode where a.bondabbr='20国开08' order by a.marketvalue desc limit 1;	ccks_fund	找出持仓20国开08市值最高的经理和基金管理人
select chinameabbr from lc_stockarchives where generalmanager like '刘%';	ccks_stock	总裁姓刘的上市公司有哪些
select mainoperincome, mainoperprofit from lc_mainoperincome  where strftime('%Y', enddate) = strftime('%Y', DATE('now', '-1 year')) and secucode ='000752';	ccks_stock	000752去年的主主营业务收入和主营业利润有多大，帮我瞅瞅 感谢
select a.secuabbr,b.manager from mf_benchmarkgrowthrate as a  join mf_fundarchives as b on a.innercode=b.innercode  where a.dailybenchgr<0;	ccks_fund	本日基金基准增长幅度为负的基金及经理
select legalrepr,generalmanager from lc_stockarchives where chinameabbr='维宏股份';	ccks_stock	有维宏股份的法定责任人和总裁的信息吗
select secuabbr,benchgrfor1year from mf_benchmarkgrowthrate;	ccks_fund	看看每个基金和它们的一年基金基准增长幅度
select secuabbr,secucode,investadvisorname from mf_fundarchives where manager='张坤';	ccks_fund	列出经理是张坤的基金、代码及基金管理人
select chinameabbr, controllername from lc_actualcontroller where secucode like '300%' order by secucode;	ccks_stock	列出股票代码以300开头的上市公司简称，对应实控人，并按照股票代码排序 谢谢啊
select a.education, count(*) from mf_personalinfo as a join mf_fmscaleanalysisn as b on a.personalcode = b.personalcode where b.totalfundnv > 100 group by a.education;	ccks_fund	管理基金规模超过100亿的基金经理最高学历分布情况
select shname, secucode, shinvestsum from lc_relatedsh  where shinvestsum > 10000000 and strftime('%Y', enddate) = strftime('%Y', DATE('now', '-2 year')) ;	ccks_stock	同学你好！前年开始，股东投资总额超过1千万的股东名称有哪些，列出股东、股票代码和股东投资总额
select chinameabbr from lc_shnumber where holdproportionpaccount<10;	ccks_stock	列出户均持股占比小于10%的公司
select b.secuabbr,b.type from mf_benchmarkgrowthrate as a join mf_fundarchives as b on a.innercode=b.innercode  where a.monthlybenchgr<0;	ccks_fund	列出一个月基金基准增速为负的基金和基金类型 谢谢啊
select b.education, count(*) from mf_fmperfanalysis as a join mf_personalinfo as b on a.personalcode = b.personalcode where a.annalphacoef > 0.5 group by b.education	ccks_fund	你好，基金经理管理基金的年化阿尔法超过0.5的有多少位，按基金经理最高学历分组展示
select b.secuabbr,b.investadvisorname from mf_benchmarkgrowthrate as a join mf_fundarchives as b on a.innercode=b.innercode  where a.monthlybenchgr>8;	ccks_fund	找出一个月基金基准增速高于8%的基金及基金管理人
select serviceline from mf_investadvisoroutline where investadvisorabbrname = '方正富邦基金';	ccks_fund	我要向方正富邦基金咨询业务，麻烦给我一下客服电话 感谢
select b.manager,b.investadvisorname from mf_fmscaleanalysisn as a join mf_fundarchives as b on a.chinesename=b.manager order by a.numberoffunds desc limit 1;	ccks_fund	找出那个经理旗下基金总数做多，及基金管理人是谁
select shname, holdingsum from lc_relatedsh  where secucode ='000948' and strftime('%Y', enddate) > strftime('%Y', DATE('now', '-3 year'));	ccks_stock	麻烦帮我看下000948最近三年的股东及股东持股数目
select a.secucode , b.legalrepr , b.secretarybd from lc_coconcept as a join lc_stockarchives as b on a.companycode = b.companycode where a.conceptname ='工业互联网' ; 	ccks_stock	嗨，能查一下"工业互联网"这个板块有哪些股票吗，列出股票代码和法定代表，还有董事长秘书名称
select chinesename from mf_personalinfo  where nationality = '缅甸' and strftime('%Y', practicedate)='2015';	ccks_fund	请问2015年以后才开始从业的缅甸基金经理是哪些
select chinameabbr from lc_mainoperincome  where strftime('%Y', enddate) = strftime('%Y', DATE('now', '-1 year')) order by  mainoperincome desc limit 1;  	ccks_stock	帮我找找数据，去年哪家公司的营收最多
select b.chinesename, b.totalfundnv, b.equityfundnv, b.hybridfundnv from mf_personalinfo as a join mf_fmscaleanalysisn as b on a.personalcode = b.personalcode where a.nationality != '关岛';	ccks_fund	非'关岛'籍基金经理有哪些？管理基金总规模，股票型基金规模，混合型基金规模分别是多少
select shname,oughtshares,actualshares from lc_largeshsubscription where chinameabbr='双节电气';	ccks_stock	查询双节电气的配股大股东名称及应配、实配股数情况
select b.secuabbr,b.investtarget from mf_benchmarkgrowthrate as a join mf_fundarchives as b on a.innercode=b.innercode  order by a.monthlybenchgr desc limit 10;	ccks_fund	帮我查一下这些数据。找出一个月基金基准增速排名前十的基金及投资目标
select secuabbr from mf_fundarchives where fundtype='其他型' and investstyle='配置型';	ccks_fund	其他型基金中配置型投资风格的基金都有哪些 谢谢啊
select investadvisorabbrname from mf_investadvisoroutline where regcapital < 1000000000;	ccks_fund	哪些基金管理人的注册资本小于10亿
select secucode, controllername from lc_actualcontroller where secucode = '600881' or secucode = '601158';	ccks_stock	罗列出我持仓股票600881、601158的实控人
select secuabbr,dailybenchgr from mf_benchmarkgrowthrate where dailybenchgr>0 order by dailybenchgr desc;	ccks_fund	本日基金基准增速大于0的基金由高到低的排名
select b.chinameabbr, b.controllername from lc_stockarchives as a join lc_actualcontroller as b on a.companycode = b.companycode where a.city = '杭州市';	ccks_stock	你好，杭州市上市公司的实际控制人名称信息
select count(*) from mf_fundarchives  where secumarket='上海黄金交易所' and type='开放式' and strftime('%Y', listeddate)='2021';	ccks_fund	嘿，2021年在上海黄金交易所上市了多少开放式基金？
select b.manager,a.bondabbr from mf_bondportifoliodetail as a join mf_fundarchives as b on a.innercode=b.innercode where a.secuabbr='富国天丰';	ccks_fund	给出富国天丰的经理和持仓的债券信息
select businessminor from lc_business lb where chinameabbr ='深科技'	ccks_stock	深科技的经营范围是什么 感谢
select secucode from mf_fundarchives where secuabbr='易方达人工智能ETF';	ccks_fund	列出易方达人工智能ETF基金的代码
select b.type, count(*) from mf_fundreturnrank as a join mf_fundarchives as b on a.innercode = b.innercode where a.indexcycle = '一年' and a.fundreturn < 0 group by b.type	ccks_fund	显示指标周期为"一年"的基金收益为负的基金数目，按基金运作形式分组展示
select fpshname, accufpshares from lc_sharefpsta where chinameabbr = '新天然气' and accupctofpled > 0.8	ccks_stock	帮我找找数据，新天然气的累计占冻结质押方持股数占比超过0.8的冻结质押股东名称及冻结质押股数
select count(*) from lc_stockarchives as a join lc_freefloat as b on a.companycode = b.companycode where a.state = '江苏省' and b.adjfreefloatratio = 100	ccks_stock	在江苏省中，自由流通比重为100%的公司有多少家
select shname, holdingpct from lc_relatedsh where chinameabbr = '诺德股份';	ccks_stock	诺德股份这只股票值得买吗，它的参股股东名称有哪些，分别持股比例是多少 感谢
select chinameabbr from lc_financialexpense order by netinterestexpense asc	ccks_stock	帮我找一下数据！按利息净支付升序排列公司名称
select shname,oughtshares from lc_largeshsubscription where chinameabbr='天山股份';	ccks_stock	天山股份的配股股东及其应配股数分别是？
select shname from lc_largeshsubscription where secucode='600797';	ccks_stock	给出600797的配股股东信息
select mainoperincome , mainopercost, mainoperprofit from lc_mainoperincome  where strftime('%Y', enddate) = strftime('%Y', DATE('now', '-1 year')) and secucode ='000822';	ccks_stock	找一下数据。000822上一年的经营情况如何，展示营业收入、营业总成本、主营业务利润
select ashareabbr,astockcode from lc_stockarchives where astockcode='600190';	ccks_stock	同学你好！看下600190的股票简称和证券代码
select mainbusiness, industryname from lc_business where chinameabbr = '精研科技'	ccks_stock	看看精研科技的主营和所属行业
select b.chinameabbr from lc_intassetsdetail as a join lc_stockarchives as b on a.companycode=b.companycode  where b.state='广东省' order by a.rdstaffnum desc limit 50;	ccks_stock	广东省研发人员数量最多的50个公司
select secuabbr,benchgrforthisweek from mf_benchmarkgrowthrate where benchgrforthisweek<0 order by benchgrforthisweek;	ccks_fund	你好，列出本周以来基金基准增速为负的基金由低到高的排名，还有增长率分别是多少
select a.secuabbr from mf_fundreturnrank as a join mf_fundarchives as b on a.innercode = b.innercode where b.fundtype = '债券型' and a.fundreturnmean > 0	ccks_fund	列出基金类别为"债券型"，且同类基金收益率均值大于0的基金名称
select b.secuabbr,b.manager from mf_bondportifoliodetail as a join mf_fundarchives as b on a.innercode=b.innercode group by b.secuabbr order by count(*) desc limit 1;	ccks_fund	我想了解一下数据情况。持仓债券种类最多的基金和经理
select b.manager,a.bondabbr,a.marketvalue from mf_bondportifoliodetail as a join mf_fundarchives as b on a.innercode=b.innercode where a.secuabbr='富国天丰';	ccks_fund	谁是富国天丰的经理，持有哪些债券，市值分别是多少？
select b.secuabbr,b.manager from mf_bondportifoliodetail as a join mf_fundarchives as b on a.innercode=b.innercode where a.bondabbr='南银转债';	ccks_fund	给出重仓南银转债的基金和经理
select underwritingvol from lc_issueandlistagent where chinameabbr='天健集团';	ccks_stock	天健集团股票在发行时机构的承销额
select chinameabbr from lc_shnumber where avgholdsumgrquarter<5;	ccks_stock	帮我找找数据，给出户均持股数季度增速低于5%的公司
select b.secuabbr,b.manager from mf_bondportifoliodetail as a join mf_fundarchives as b on a.innercode=b.innercode where a.bondabbr='杭银转债';	ccks_fund	同学你好！列一下持有杭银转债的基金和经理
select a.secuabbr from mf_fundrisklevel as a join mf_fundarchives as b on a.innercode = b.innercode where a.risklevel = '中' and b.fundtype= '债券型'	ccks_fund	帮我找找数据，基金类别为"债券型"基金的基金风险评级为"中"的有哪些？
select chinameabbr,regarea from lc_stockarchives where city='长春市';	ccks_stock	找到长春市上市公司及所属区县信息
select a.name, b.education from mf_fundmanagernew as a join mf_personalinfo as b on a.personalcode = b.personalcode order by a.managementtime desc limit 1	ccks_fund	帮我查一下，任职天数最高的基金经理姓名和最高学历 谢谢
select a.chinameabbr, a.generalmanager, a.legalrepr from lc_stockarchives as a join lc_actualcontroller as b on a.companycode = b.companycode where b.nationalitydesc = '美国';	ccks_stock	展示那些美国公司控股的上市公司，包括简称、总裁、法定代表
select shname,actualshares from lc_largeshsubscription where secucode='600110';	ccks_stock	嘿，600110的配股大股东名称及实配和应配股数信息
select organizationform, count(*) from mf_investadvisoroutline group by organizationform;	ccks_fund	不同公司性质的基金公司分别有多少家
select a.fullname,a.underwritingsum,b.shname,b.actualshares from lc_issueandlistagent as a join lc_largeshsubscription as b on a.companycode=b.companycode where a.chinameabbr='天健集团';	ccks_stock	列出天健集团股票发行时聘请的机构及承销金额，还有配股大股东名称及实配股数
select shname from lc_relatedsh  where holdingsum > 10000000 and strftime('%Y', enddate)='2020' ;	ccks_stock	哪些股东2020年的持股数量在1千万以上，列出这些股东名称
select secuabbr from mf_fundreturnrank where indexcycle = '今年以来' and fundreturn < 0	ccks_fund	查找一下指标周期为"今年以来"的基金收益率小于0的基金名称
select depositswithcentralbank  from ed_otherdepositorycorpbs ;	ccks_macro	列出准备金存款在其他存款性公司资产负债表中的数据记录
select fpshname from lc_sharefpsta where chinameabbr = '哈尔斯' or chinameabbr = '京运通'	ccks_stock	帮我查一下哈尔斯和京运通的冻结质押股东名称 谢谢
select enddate, claimsongovernment , claimsoncentralbank from ed_otherdepositorycorpbs  where strftime('%Y', enddate) = strftime('%Y', DATE('now', '-1 year')) and round(strftime('%m',enddate)/3.0 + 0.495) = 4;	ccks_macro	siri, 去年第四季度，在其他存款性公司资产负债表中，我国对政府债权金额和对中央银行债权分别有多少
select count(*) from mf_fundreturnrank where secucode like '16%' and fundreturn > 0	ccks_fund	基金代码以16开头的，基金收益率大于0的基金有多少只
select chinesename from mf_fmscaleanalysisn where equityfundnv > 200;	ccks_fund	筛选出管理股票型基金总规模超过200亿的所有基金经理名称
select investadvisorname from mf_fundarchives where investmenttype='指数型' group by investadvisorname order by count(*) desc limit 1;	ccks_fund	你好，哪个基金管理人管理的指数型基金最多
select turnovervolume, turnovervalue from qt_dailyquote where chinameabbr = '科思股份';	ccks_stock	嘿，科思股份每天的总成交量和总成交金额
select chinesename from mf_personalinfo where chinesename like '王%' and experiencetime > 10;	ccks_fund	哪些王姓基金经理的从业时间超过10
select secucode, chinameabbr from lc_dividend where bonusshareratio is not null;	ccks_stock	麻烦查一下有送股记录的公司代码和股票名称
select playear, plaprice, plaproceeds from lc_ashareplacement where chinameabbr = '四川美丰';	ccks_stock	找一下数据。列出四川美丰历史所有配售年份，配股价格, 募集总金额
select fund from mf_awards where fundcompany ='鹏华基金管理有限公司';	ccks_fund	您好，小李呀，听说"鹏华基金管理有限公司"的基金都不错，它的哪些基金获得过奖项，列一下
select count(*) from mf_chargeratenew where clienttype ='养老金客户';	ccks_fund	计算一下面向"养老金客户"的基金有多少种 谢谢啊
select b.type from mf_netvalueperformancehis as a join mf_fundarchives as b on a.innercode = b.innercode group by b.type order by avg(a.nvdailygrowthrate) desc limit 1;	ccks_fund	嘿，计算出哪种基金运作方式对应的日回报率均值最大
select accumulatedunitnv from mf_netvalue  where secuabbr = '国投瑞盈' and strftime('%Y', enddate) = strftime('%Y', date());	ccks_fund	展示我持仓基金产品国投瑞盈今年的累计净值数据
select sponsorname from lc_ipodeclaration where chinameabbr='红塔证券';	ccks_stock	hello,红塔证券ipo的保荐人
select csrcindustryname from lc_ipodeclaration where strftime('%Y', enddate)>'2017' group by csrcindustryname order by count(*) desc limit 1;	ccks_stock	2017年后哪个行业ipo公司最多
select indexvalue from ed_producerpiformp  where indexname ='金属制品业' and reportperiod ='上年同期' and strftime('%Y', enddate) = strftime('%Y', DATE('now', '-1 year')) ;	ccks_macro	我想看看"金属制品业"去年"上年同期"的指数值
select rrinfiveyear from mf_netvalueperformancehis ;	ccks_fund	查询一下基金的五年回报率数值
select ratioceiling from ed_taxrate where typename ='农村信用社' and itemname ='超额存款准备金率';	ccks_macro	帮忙查下"农村信用社""超额存款准备金率"的最高比率 谢谢
select b.chinameabbr, a.firstindustryname from lc_exgindustry as a join lc_sharestru as b on a.companycode = b.companycode where b.totalshares > 10000000000	ccks_stock	展示总股本超过100亿上市公司的公司名称、所属一级行业
select gdp, primaryindustrygdp, secondindustrygdp, thirdindustrygdp from ed_grossdomesticproduct ;	ccks_macro	让我瞅瞅咱们国内生产总值是多少，第一二三产业的国内生产总值分别是多少
select practicedate from mf_personalinfo where chinesename = '柳军';	ccks_fund	基金经理柳军的什么时候开始从业的
select b.leadername, b.chinameabbr from lc_stockarchives as a join lc_executivesholdings as b on a.companycode = b.companycode where a.state = '浙江省' and b.positiondescription like '%副总经理%'	ccks_stock	找出浙江省在公司担任"副总经理"的高管姓名及所在公司名称
select conceptname from lc_coconcept where secucode ='002354';	ccks_stock	哥，我想买002354这支股票，帮我查一下它是什么板块的
select a.chinameabbr , b.state, b.city from lc_business as a join lc_stockarchives as b on a.companycode = b.companycode where a.industryname ='资本市场服务';	ccks_stock	帮我看看"资本市场服务"行业的上市公司名称是什么，所在的省份和城市分别是哪里哦
select nationalitydesc, count(chinameabbr) from lc_actualcontroller group by nationalitydesc;	ccks_stock	A股上市公司的实控人国籍在各国、各地区分布情况
select secuabbr,secucode from mf_bondportifoliodetail where bondcode='128125'	ccks_fund	快速找一下数据。看下哪些基金持有128125，及基金代码都是多少
select chinameabbr from lc_stockholdingst  where strftime('%Y', enddate)='2021' order by  trustcompaniesholdpropa desc limit 10;	ccks_stock	给出2021年信托公司持有无限售流通A股比例最高的前十家公司
select bonds, centralbankbonds from ed_chinamoneyandbanking  where strftime('%Y', enddate) = strftime('%Y', DATE('now', '-1 year')) ;	ccks_macro	能列出去年我国债券和央行债券的详细记录吗 谢谢啊
select a.chinameabbr from lc_stockarchives as a join lc_exgindustry as b on a.companycode = b.companycode where a.state = '广东省' and b.firstindustryname = '房地产业'	ccks_stock	列出广东省二级行业为"房地产业"的公司 感谢
select b.chinameabbr,a.shname from lc_largeshsubscription as a join lc_stockarchives as b on a.companycode=b.companycode  where b.city='广州市';	ccks_stock	广州市上市公司及其配股股东
select leadername, chinameabbr from lc_executivesholdings where positiondescription like '%董事长%' or positiondescription like '%副董事长%'	ccks_stock	找到所有职位为"董事长"或者"副董事长"的高管姓名及公司名称
select b.chinameabbr, b.ashares from lc_exgindustry as a join lc_sharestru as b on a.companycode = b.companycode where a.firstindustryname = '制造业' order by b.ashares desc	ccks_stock	请查询制造业上市公司名称及A股股本信息，并按A股股本大小降序排列
select maturity, ratiofloor, ratioceiling from ed_taxrate where typename ='国债买断式回购' and itemname ='经手费'; 	ccks_macro	查一下"国债买断式回购"在不同交易市场交易时，"经手费"的最高和最低比率
select localgovrevenue, localgovexpenditure from ed_financialbalance  where strftime('%Y', enddate)='2010' ;	ccks_macro	2010年以前，我国各省市的地方财政收入和支出分别是多少
select count(*) from mf_awards where awardname = '三年持续回报明星基金公司奖';	ccks_fund	siri, 请统计一下获得过"三年持续回报明星基金公司奖"的基金数量
select enddate, totalassets, totalliabilities from ed_otherdepositorycorpbs where totalliabilities < 5000000 and totalassets > 50000000;	ccks_macro	找一下数据。在其他存款性公司资产负债表中，总资产金额超过5千万，而总负债金额不足5千万的记录是哪些，展示一下时间、总资产金额和总负债金额
select a.chinesename, b.education from mf_fmretandscalerank as a join mf_personalinfo as b on a.personalcode = b.personalcode where a.timeinterval = '近1年' order by a.returntypeavg desc limit 5	ccks_fund	时间区间为"近1年"，同类经理收益率均值排名前5的基金经理姓名和学历
select b.chinameabbr from lc_stockarchives as a join lc_freefloat as b on a.companycode = b.companycode where a.state = '广东省' and b.totalashare > 100000000	ccks_stock	找到广东省A股总股本超过1亿的公司名称
select fundcompany from mf_awards where appraisalorgcode ='14561';	ccks_fund	搜一下"14561"这家机构给哪些基金公司颁发过奖项
select gdp, gdppercapita from ed_grossdomesticproduct where province ='浙江';	ccks_macro	hello,浙江省历年gdp和人均gdp记录分别是什么
select  secucode, secuabbr from mf_netvalueperformancehis where annualizedrrsincestart > 30;	ccks_fund	列出设立以来年化回报率超过30%的基金名称和代码
select secuabbr from mf_benchmarkgrowthrate where dailybenchgr>0 order by dailybenchgr desc	ccks_fund	本日基金基准增长率大于0的基金由高到低的排名 感谢
select stateownedunits, collectiveunits, jointventures from ed_retailvalueofscgoods ;	ccks_macro	请查一下我们国有单位、集体单位和合营单位的不同的社会消费品零售金额
select secucode , mainoperprofit from lc_mainoperincome where mainoperprofit > 100000000;	ccks_stock	历史上主营业务利润超过1亿元的公司有哪些，列出公司代码和主营业务利润
select fullname from lc_issueandlistagent where chinameabbr='天健集团';	ccks_stock	天健集团的股票在发行或上市时聘请的机构
select enddate, province, primaryindustrygdp, secondindustrygdp, thirdindustrygdp from ed_grossdomesticproduct  where strftime('%Y', enddate) > strftime('%Y', DATE('now', '-5 year') ) ;	ccks_macro	你知道这5年来，全国各省市第一二三产业的gdp吗 感谢
select a.state, count(*) from lc_stockarchives as a join lc_business as b on a.companycode = b.companycode where b.industryname ='医药制造业' group by a.state ;	ccks_stock	帮我找找数据，统计一下各省市"医药制造业"的上市公司分别是多少家
select fullname,underwritingsum from lc_issueandlistagent where secucode='000401';	ccks_stock	承销000401的股票的机构及承销金额分别是多少
select chinameabbr, secucode from lc_legaldistribution  where strftime('%Y', infopubldate) = strftime('%Y', DATE('now', '-1 year'));	ccks_stock	嘿，去年配售股份的公司有哪些，列出股票名称和股票代码
select imvalueofgoods , exvalueofgoods from ed_exportimport  where gyoyofexvaluegoods > 0 and gyoyofimvaluegoods < 0 and strftime('%Y', enddate)='2000';	ccks_macro	帮我列出2000年以前，我国出口同比增长，而进口同比减少的数据，列出进口金额和出口金额
select cashdivirmb from lc_dividend where secucode ='000021';	ccks_stock	快速找一下数据。之前000021有派现吗，帮我整理一下派现记录
select rrintwoyear from mf_netvalueperformancehis ;	ccks_fund	hello,请给王工查一下各基金的两年回报率数值大小
select count(*) from lc_ashareseasonednewissue  where strftime('%Y', advancedate)='2020';	ccks_stock	展示一下数据，请问2020年有多少次股票增发
select shname,actualshares from lc_largeshsubscription where secucode='600110';	ccks_stock	600110的配股大股东有哪些以及分别实际配了多少股 谢谢啊
select secuabbr from mf_fundarchives order by establishmentdate asc limit 1	ccks_fund	设立时间最早的基金
select secuabbr,marketvalue from mf_bondportifoliodetail where bondcode='128125'	ccks_fund	有基金持有128125吗，市值都是多少
select b.chinesename from mf_managerexperience a join mf_personalinfo b on a.personalcode = b.personalcode order by a.employmentcompany desc limit 1	ccks_fund	展示一下数据，在一家基金公司最待得住的基金经理
select annualizedrrintenyear from mf_netvalueperformancehis ;	ccks_fund	展示一下数据，你知道基金的十年年化回报率是多少吗
select chiname from mf_fundarchives where secucode='160215';	ccks_fund	160215的基金名称是什么 谢谢啊
select a.city , count(*)  from lc_stockarchives as a join lc_coconcept as b on a.companycode = b.companycode where b.conceptname ='国产软件' group by a.city;	ccks_stock	帮忙计算一下，"国产软件"这个板块的上市公司，在各个城市的分布情况，列出城市名称和数量
select b.type, count(*) from mf_netvalueperformancehis as a join mf_fundarchives as b on a.innercode = b.innercode where a.rrinsingleyear > 20 group by b.type;	ccks_fund	siri, 麻烦帮我统计一下不同基金运作方式各有几只基金产品一年回报率超过20%
select cashdivirmb from lc_dividend where secucode ='000040';	ccks_stock	我朋友持有000040好几年了，它历史上派现多少
select divintervaldes, chargeratedes from mf_chargeratenew where secuabbr ='富国创新药ETF';	ccks_fund	嘿，"富国创新药ETF"的费率划分区间是哪种，费率是哪种
select count(*) from lc_ashareplacement where plaproceeds > 10000000000;	ccks_stock	请问发生过募集金额超过100亿的股票配售记录吗？总共有几次
select otherforeignassets, abroadliability from ed_moneyauthoritybs ;	ccks_macro	你好，那你再查一下对其他国外资产和国外负债的数据记录，还是在货币当局资产负债表中
select leadername, chinameabbr from lc_executivesholdings where positiondescription like '%董事长%' and positiondescription like '%总经理%'	ccks_stock	找到同时担任"董事长"和"总经理"的高管姓名及所在公司 谢谢
select industryname from lc_business where chinameabbr ='精研科技'	ccks_stock	列出精研科技的所属行业
select rrinthreeyear from mf_netvalueperformancehis ;	ccks_fund	请给我查一下基金的三年回报率数据大小
select accountingfirm,signatureaccountant from lc_ipodeclaration where chinameabbr='大业股份'; 	ccks_stock	给出大业股份ipo的会计所和签字会计师信息
select actualshares from lc_largeshsubscription where chinameabbr='深科技';	ccks_stock	深科技的配股数
select chinameabbr from lc_exgindustry where secondindustryname = '资本市场服务'	ccks_stock	hello,二级行业为"资本市场服务"包括哪些公司？
select b.totalrdinput from lc_ipodeclaration as a join lc_intassetsdetail as b on a.companycode=b.companycode  where strftime('%Y', a.enddate)>'2018' and a.sponsorname='广发证券';	ccks_stock	2018年后保荐人是广发证券的公司的投入占比
select thirdindustrygdp from ed_grossdomesticproduct ;	ccks_macro	帮我找一下数据！我国第三产业国内生产总值这些年来的记录是什么样的
select state,legalrepr from lc_stockarchives where chinameabbr='五粮液';	ccks_stock	问下五粮液是哪个省的企业，法人代表是谁？
select otherinstiholdpropa from lc_stockholdingst  where strftime('%Y', enddate)='2020' and round(strftime('%m',enddate)/3.0 + 0.495)=1 and chinameabbr='步步高';	ccks_stock	2020年1季度其他机构持有的步步高的非限售流通股比例 谢谢
select totalassets from ed_moneyauthoritybs ;	ccks_macro	找一下数据。你能帮我查一下，在货币当局资产负债表中，总资产的金额大小吗
select authorizer from lc_sharetrustee  where strftime('%Y', infopubldate)='2018' and chinameabbr='新日恒力' order by  pctofauthorizer desc limit 1;	ccks_stock	siri, 2018年授权新日恒力股份的授权方哪个股权占授权方比例最高
select eximvalueofgoods, imvalueofgoods, exvalueofgoods from ed_exportimport ;	ccks_macro	帮忙统计一下这些年来，我国进出口商品总金额，以及进口商品金额和出口商品金额情况
select a.education, max(b.totalfundnv) from mf_personalinfo as a join mf_fmscaleanalysisn as b on a.personalcode = b.personalcode group by a.education;	ccks_fund	我想看一下不同基金经理学历水平管理基金总规模最大分别为多少
select secucode from lc_mainoperincome where mainincomegrowrateyoy < 0 and strftime('%Y', enddate)<'2019';	ccks_stock	列出2019年以前，主营业务收入同比为负数的公司代码 感谢
select leadername, positiondescription, chinameabbr from lc_executivesholdings  where strftime('%Y', enddate)='2020' order by  shareamount desc limit 5	ccks_stock	2020年，期末持股数排名前5的高管姓名、职位及所在公司名称
select avg(ratioinnv)  from mf_keystockportfolio where secuabbr = '富国天惠A'	ccks_fund	富国天惠A基金重仓股平均占资产比例 感谢
select enddate,  subjectsum from ed_newincreasingloan where reportperiod ='期末累计' ;	ccks_macro	王老师在统计数据，请给他提供一份咱们每年按"期末累计"记录的贷款新增金额数据
select b.manager,a.bondabbr from mf_bondportifoliodetail as a join mf_fundarchives as b on a.innercode=b.innercode where a.secucode='160615';	ccks_fund	哪个经理在管理160615，持仓了哪些债券
select fullname,address from lc_issueandlistagent where chinameabbr='湖北宜化';	ccks_stock	帮我找找数据，湖北宜化股票发行的中介机构的名称和地址
select totalsavings , totalloans from ed_chinafibalancesheetrmb; 	ccks_macro	金融机构的各项存款和各项借款总额分别是多少啊
select chinameabbr,qfiiholdpropa from lc_stockholdingst  where strftime('%Y', enddate)='2020';	ccks_stock	找一下数据。2020年QFII持有各公司的无限售流通A股比例的情况
select b.chinesename from mf_managerexperience a join mf_personalinfo b on a.personalcode = b.personalcode order by a.employmentcompany asc  limit 1	ccks_fund	哪个基金经理在一个基金公司待的时间最短 感谢
select totalshare, floatshare from qt_monthdata where chinameabbr = '东方电子';	ccks_stock	帮我查一下东方电子月频流通股本和总股本数据
select retailvalueofscgoods from ed_retailvalueofscgoods where province ='北京' and reportperiod ='期末累计' and strftime('%Y', enddate)>='2000';	ccks_macro	2000年至今，北京市"期末累计"社会消费品零售总金额是多少
select closeprice, floatshare from qt_monthdata where secucode = '000822';	ccks_stock	000822月频收盘价、流通股本信息
select chinesename from mf_fmscaleanalysisn order by numberoffunds desc limit 1;	ccks_fund	当前哪位基金经理同时管理的基金数量最多
select b.secuabbr from mf_netvalueperformancehis as a join mf_fundarchives as b on a.innercode = b.innercode where b.fundtype = '股票型' and a.rrinsingleweek > 5;	ccks_fund	基金类型为股票型的产品中，哪些一周回报率大于5%
select secuabbr from mf_fundarchives  where strftime('%Y', establishmentdate)=strftime('%Y', DATE('now', '-1 year')) and round(strftime('%m',establishmentdate)/3.0 + 0.495)=1	ccks_fund	去年一季度设立的基金有哪些
select city from lc_stockarchives where state='广东省' group by city order by count(*) desc limit 1; 	ccks_stock	广东省哪个城市上市公司最多？
select chinameabbr from lc_actualcontroller where nationalitydesc = '美国';	ccks_stock	有哪些公司的实控人来自美国
select shname, secucode, holdingsum from lc_relatedsh  where holdingsum > 10000000  and strftime('%Y', enddate) >= strftime('%Y', DATE('now', '-2 year'));	ccks_stock	从前年起，投资数量超过1千万的股东有哪些，列出股东名称、股票代码和投资数量
select  fund from  mf_awards  where strftime('%Y', `year`) >=2010 and appraisalorg ='中国证券报' ;	ccks_fund	2010年至今，有哪些基金获得过"中国证券报"设立的奖项
select mainoperincome, mainopercost, mainoperprofit from lc_mainoperincome  where strftime('%Y', enddate) = strftime('%Y', DATE('now', '-1 year')) and chinameabbr ='古井贡酒';	ccks_stock	哈喽，帮我看下去年古井贡酒的经营状况，列出主营业收入，主营业成本和主营业利润
select shname, holdingpct from lc_relatedsh where chinameabbr = '诺德股份';	ccks_stock	诺德股份这只股票值得买吗，它的参股股东有哪些，分别持股比例是多少 感谢
select a.chinameabbr, b.firstindustryname from lc_sharetransfer as a join lc_exgindustry as b on a.companycode = b.companycode where a.pctaftertran > 0.5	ccks_stock	返回出让后持股比例超过0.5的公司名称及所属一级行业
select a.secuabbr from mf_netvalueperformancehis as a join mf_fundarchives as b on a.innercode = b.innercode and b.fundtype ='股票型' where a.annualizedrrsincestart > 50;	ccks_fund	你知道"股票型"基金中设立以来年化收益率超过50%的有哪些 谢谢啊
select b.secuabbr from mf_benchmarkgrowthrate as a join mf_fundarchives as b on a.innercode=b.innercode where a.benchgrfor6month>5 and b.investmenttype='指数型';	ccks_fund	帮我找找数据，指数型基金中有哪些六个月基金基准增长率超过5%
select  secucode, secuabbr  from mf_netvalueperformancehis where rrsincestart < -30;	ccks_fund	把那些设立以来亏了很多的基金代码找出来，列出设立以来收益率低于-30%的基金代码和名称
select a.secuabbr, b.foundedsize, b.fundtype from mf_netvalueperformancehis as a join mf_fundarchives as b on a.innercode = b.innercode order by a.nvdailygrowthrate desc limit 3;	ccks_fund	展示日回报率排行前3的基金产品，以及他们的基金规模，基金类别信息
select mainbusiness from lc_business where chinameabbr ='深科技'	ccks_stock	深科技的主营业务是什么
select enddate, stateownedcontrolledcomap, collectivecomap from ed_industryproduction where province ='上海' and statstandard ='全部工业企业' and reportperiod ='期末累计' ;	ccks_macro	你知道上海市的"全部工业企业"中，国有及控股企业和集体企业每年的"期末累计"工业生产总值金额吗 感谢
select secucode , unitnv from  mf_netvalue ;	ccks_fund	查一下各个基金的单位净值，列出基金代码
select involvedtrustsum from lc_sharetrustee  where strftime('%Y', infopubldate)='2016' and chinameabbr='澳柯玛';	ccks_stock	2016年澳柯玛一共有多少股权被托管
select a.secuabbr, a.secucode from mf_netvalueperformancehis as a join mf_fundarchives as b on a.innercode = b.innercode and b.fundtype ='混合型' where a.annualizedrrsincestart > 30;	ccks_fund	快速找一下数据。请列举出来，设立以来年化收益率超过30%的"混合型"基金的代码和名称
select divibase, bonusshareratio, tranaddshareraio from lc_dividend  where secucode ='000728' and strftime('%Y', dividendimplementdate) > strftime('%Y', DATE('now', '-2 year'));	ccks_stock	帮我统计下最近两年古井贡酒的派新金额和实派人民币金额 感谢
select secuabbr, nvdailygrowthrate, rrinsingleweek from mf_netvalueperformancehis where rrinsinglemonth > 5;	ccks_fund	我想知道一个月回报在5%以上的基金有哪些？并展示它们的日回报率，一周回报率情况
select b.secuabbr, b.risklevel from mf_fundmanagernew as a join mf_fundrisklevel as b on a.innercode = b.innercode where strftime('%Y', a.accessiondate)>'2021'	ccks_fund	帮我查一下到任日期在2021年以后的基金经理所管理的基金名称及基金风险等级
select mainbusiness from lc_business where chinameabbr ='浙大网新'	ccks_stock	帮我查一下浙大网新的主营业务
select monthlybenchgr from mf_benchmarkgrowthrate where secuabbr='华夏行业';	ccks_fund	看下华夏行业基金一个月基金基准增长率是多少
select count(*) from lc_stockarchives where city='厦门市';	ccks_stock	看下厦门有多少上市公司
select b.secuabbr,b.manager,b.investtarget from mf_benchmarkgrowthrate as a join mf_fundarchives as b on a.innercode=b.innercode where a.benchgrfor5year>20;	ccks_fund	嘿，查下五年基金基准增长率超过20%的基金、经理和投资投资目标
select b.secuabbr,b.manager from mf_bondportifoliodetail as a join mf_fundarchives as b on a.innercode=b.innercode where a.bondabbr='海亮转债';	ccks_fund	给出持有海亮转债的基金和基金经理
select avgaumtypeavg from mf_fmretandscalerank where chinesename = '贾成东';	ccks_fund	hello,查一下贾成东管理的基金平均规模有多大
select a.city , count(*)  from lc_stockarchives as a join lc_coconcept as b on a.companycode = b.companycode where b.conceptname ='云计算'group by a.city order by count(*) desc limit 1 ;	ccks_stock	你好，查一下"云计算"板块，上市公司数量最多城市是哪个，并列出数量
select stateownedunits from ed_retailvalueofscgoods ;	ccks_macro	展示一下数据，能展示一下我们国有单位这些年的社会消费品零售金额吗
select buybacksum, buybackmoney from lc_buyback where secucode = '300011';	ccks_stock	300011的股份回购数量和总金额是多少
select rrsincestart from mf_netvalueperformancehis ;	ccks_fund	李工说他在选基金，想让帮他查一下基金设立以来回报率的金额
select rrinthreemonth, rrinsixmonth, rrinsingleyear from mf_netvalueperformancehis where secuabbr = '博时策略';	ccks_fund	列出博时策略的三个月、半年和一年回报率数据
select fpshname, sum(accufpshares) from lc_sharefpsta where chinameabbr = '完美世界' group by fpshname	ccks_stock	分组展示完美世界各冻结质押股东名称及所持的冻结质押股数总和
select buybacksum, percentage from lc_buyback where chinameabbr = '南都电源' order by advancedate desc limit 1 	ccks_stock	您好，南都电源最近一次股份回购的数量是多少，占总股本的比例是多少
select count(*) from lc_mainoperincome  where strftime('%Y', enddate) = strftime('%Y', DATE('now', '-1 year')) and mainoperincome > 100000000;	ccks_stock	去年主营业务收入超过1亿元的公司有几个
select b.shname,a.fullname from lc_issueandlistagent as a join lc_largeshsubscription as b on a.companycode=b.companycode where a.chinameabbr='东旭蓝天';	ccks_stock	东旭蓝天股票发行时配股大股东和中介机构的名称
select otherassets, otherliabilities from ed_otherdepositorycorpbs ;	ccks_macro	最近我们要统计数据，请提供下其他存款性公司资产负债表中，我们其他资产和其他负债的数据记录
select chinesename from mf_fmscaleanalysisn order by equityfundn desc limit 1;	ccks_fund	谁管理的股票型基金数量最多
select b.firstindustryname, count(*) from lc_sharesfloatingschedule as a join lc_exgindustry as b on a.companycode = b.companycode where a.newmarketableashares > 100 group by b.firstindustryname	ccks_stock	本次新增可售A股股数超过100万股的公司有多少家，按一级行业分组展示
select a.conceptname, count(*) from lc_coconcept as a join lc_stockarchives as b on a.companycode = b.companycode where b.state ='海南省' group by a.conceptname ;	ccks_stock	能帮我查一下"海南省"的上市公司，在各个板块中的数量吗 感谢
select bondabbr from mf_bondportifoliodetail where secuabbr='鹏华价值' order by marketvalue desc limit 1;	ccks_fund	看下鹏华价值持有的市值最高的债券
select city,regarea from lc_stockarchives where astockcode='600165';	ccks_stock	找一下数据。查出600165是哪个城市和区县的
select secuabbr from mf_fundarchives where manager = '王帅'	ccks_fund	哪只基金的基金经理是王帅
select closeprice, floatshare, totalshare from qt_monthdata  where secucode = '600649' and strftime('%Y', enddate)='2021' and round(strftime('%m',enddate)/3.0 + 0.495) = 3;	ccks_stock	帮我找一下数据！查找2021年第三季度600649的收盘价，可流通股本和总股本数据
select buybacksum, percentage from lc_buyback  where chinameabbr = '江苏租赁' and strftime('%Y', advancedate)='2019' ;	ccks_stock	您好，计算一下2019年江苏租赁的股份回购数量、股份回购数量占总股本的比例
select tradingday, openprice, closeprice from qt_dailyquote where chinameabbr = '山煤国际' and strftime('%Y', tradingday)>='2018';	ccks_stock	列出山煤国际2018年至今每天的开盘价和收盘价
select leadername from lc_executivesholdings where secucode = '000430'	ccks_stock	帮我找找数据，找出股票代码是000430的公司高管
select chiname from lc_stockarchives where strftime('%Y', establishmentdate)>'2001';	ccks_stock	2001年以后成立的上市公司 谢谢啊
select sumbeforetran, pctbeforetran from lc_sharetransfer where secucode = '300707'	ccks_stock	显示300707的出让前持股数量和出让前持股比例 谢谢
select bonusshareratio, cashdivirmb from lc_dividend where chinameabbr ='东北证券';	ccks_stock	我关注东北证券好久了，它历年送股比例和派现金额是多少啊 感谢
select annualizedrrinthreeyear from mf_netvalueperformancehis ;	ccks_fund	您好，请展示一下基金的三年年化回报率数据
select b.type, avg(a.rrinsingleyear) from mf_netvalueperformancehis as a join mf_fundarchives as b on a.innercode = b.innercode group by b.type;	ccks_fund	按照基金运作方式不同统计一下基金产品的一年回报率均值分布情况
select issuepurpose from lc_ashareseasonednewissue where secucode = '300391';	ccks_stock	帮我找一下数据！300391通过股票增发募集资金的用途是啥
select enddate,  subjectsum from ed_newincreasingloan  where reportperiod ='月份' and strftime('%Y', enddate) = strftime('%Y', DATE('now', '-2 year'));	ccks_macro	你知道前年，我们按"月份"记录的人民币新增贷款金额吗，请列出来
select count(*) from lc_stockarchives where state='北京市';	ccks_stock	北京市上市公司的数量是多少
select mainoperincome, mainoperprofit from lc_mainoperincome  where strftime('%Y', enddate) = strftime('%Y', DATE('now', '-1 year')) and secucode ='000752';	ccks_stock	000752去年的主营业收入和主营业利润有多大，帮我瞅瞅 谢谢
select proportiongrhalfayear from lc_shnumber  where strftime('%Y', enddate)='2020' and chinameabbr='京基智农';	ccks_stock	展示一下数据，京基智农2020年户均持股比例半年增长率
select secuabbr from mf_bondportifoliodetail where bondcode='128125' order by holdvolume desc limit 1;	ccks_fund	哥，找到持有128125最多基金
select accumulatedunitnv , nvdailygrowthrate,nvweeklygrowthrate from  mf_netvalue where secuabbr = '华安180ETF';	ccks_fund	小李呀，我最近想买那个"华安180ETF"，你给我查查它的累计单位净值和日增长率和周增长率
select count(*)  from lc_coconcept as a join lc_stockarchives as b on a.companycode = b.companycode where a.conceptname ='互联网金融' and b.city ='杭州市';	ccks_stock	帮我计算一下"互联网金融"板块中，有多少上市公司市在"杭州市"的
select website from mf_investadvisoroutline where investadvisorabbrname = '浦银安盛基金';	ccks_fund	给我浦银安盛基金的公司网址，我要去看一下他们的信息
select fund from  mf_awards  where strftime('%Y', `year`) = strftime('%Y', DATE('now', '-2 year'));	ccks_fund	搜一下，前年，被授予奖项的基金是哪些 谢谢啊
select bonusshareratio, cashdivirmb from lc_dividend where chinameabbr ='古井贡酒';	ccks_stock	古井贡酒亏损好严重啊，就分红了，它之前送股比例多少啊，派现金额有多少
select chinameabbr from lc_issueandlistagent where underwritingvol>50000000;	ccks_stock	哪些公司的股票发行时被机构承销超过5千万股
select chinameabbr from lc_stockarchives where astockcode like '600%';	ccks_stock	列出600股票代码开头的上市公司
select annualizedrrintwoyear from mf_netvalueperformancehis ;	ccks_fund	帮我查一下这些数据。展示一下基金的二年年化回报率
select netabroadassets, domesticloans from ed_chinamoneyandbanking where strftime('%Y', enddate)<'2000';	ccks_macro	展示一下数据，我们有2000年以前的货币和银行记录吗，如果有，展示一下国外净资产和国内信贷的数据
select divintervaldes, chargeratedes from mf_chargeratenew where secucode ='159748';	ccks_fund	159748的要交的费率是哪种，划分区间是怎么描述的
select shname from lc_largeshsubscription where chinameabbr='恒生电子' order by actualshares desc limit 1;	ccks_stock	恒生电子配股最多的股东
select rrintenyear , annualizedrrintenyear from mf_netvalueperformancehis ;	ccks_fund	请列出基金十年回报率和十年年化回报率
select indexname, indexvalue from ed_producerpiformp where indextype ='工业结构分类指数' and reportperiod ='上年同月' and strftime('%Y', enddate)>='2010';	ccks_macro	2010年至今，"工业结构分类指数"中有哪些指数名称，他们的值是多少，展示"上年同月"的数据即可
select shname, secucode, shinvestsum from lc_relatedsh  where shinvestsum > 10000000 and strftime('%Y', enddate) = strftime('%Y', DATE('now', '-2 year')) ;	ccks_stock	前年开始，投资金额超过1千万的股东有哪些，列出股东名称、股票代码和投资金额
select fundtypename, count(*) from mf_fundreturnrank where indexcycle = '成立以来' and fundreturnmean > 0 group by fundtypename	ccks_fund	显示指标周期为"成立以来"的同类基金收益率均值为正的基金数目，按基金类别分组展示
select sponsorname from lc_ipodeclaration where accountingfirm='立信会计事务所' order by enddate desc limit 1;	ccks_stock	立信会计事务所的最新保荐人
select indexvalue from ed_producerpiformp where reportperiod ='上年同期' and indextype ='工业结构分类指数' and indexname ='生产资料-加工';	ccks_macro	请列出我们"上年同期"，"工业结构分类指数"中，"生产资料-加工"的指数值
select issuevolfloor, issuevolceiling from lc_ashareseasonednewissue where chinameabbr = '吉峰科技';	ccks_stock	吉峰科技股票增发设置的最低发行量下限, 最高发行量
select aquiredsum, aquireramount from lc_legaldistribution  where aquirername ='邱丕云' and strftime('%Y', infopubldate) > strftime('%Y', DATE('now', '-3 year')) order by  aquireramount desc ;	ccks_stock	"邱丕云"这三年参与过股份配售吗，列出获配数量和获配金额，获配金额按降序排列 感谢
select distributionsum, aquirername, aquiredsum from lc_legaldistribution where secucode ='600517' ;	ccks_stock	帮我找一下数据！帮我看下600517的股份配售情况，展示配售总股数、投资者名称和投资者获配股数
select secuabbr from mf_netvalueperformancehis order by rrsincestart desc limit 1;	ccks_fund	哪只基金自设立以来回报率这个指标最优
select investadvisorabbrname from mf_investadvisoroutline order by establishmentdate desc limit 1;	ccks_fund	哪家基金公司最晚成立
select indexvalue from ed_producerpiformp  where indexname ='医药制造业' and reportperiod ='上年同月' and strftime('%Y', enddate) = strftime('%Y', DATE('now', '-1 year')) and round(strftime('%m',enddate)/3.0 + 0.495) = 1 ;	ccks_macro	请问去年第一季度"医药制造业"的指数值有记录吗，请显示一下"上年同月"的值
select shname,actualshares,oughtshares from lc_largeshsubscription where secucode='000423';	ccks_stock	000423的各股东的实配和应配股数分别是多少
select shname from lc_largeshsubscription where oughtshares>2000000;	ccks_stock	有哪些配股大股东的应配股数超过2百万股
select max(pettm) from qt_monthdata  where secucode  = '600352' and strftime('%Y', enddate)='2022';	ccks_stock	帮我查一下600352这支股票在2022年的市净率最高达到多少
select totalliabilities from ed_otherdepositorycorpbs ;	ccks_macro	请列出在其他存款性公司资产负债表中，总负债的数据记录
select a.chinesename, b.background from mf_fmperfanalysis as a join mf_personalinfo as b on a.personalcode = b.personalcode where a.maxret > 2	ccks_fund	找一下数据。最大盈利超过2的基金经理姓名和背景介绍
select divstand1 , stdivstand1, endivstand1 from mf_chargeratenew where secucode ='501065';	ccks_fund	你好呀，能给我提取一下501065的费率划分标准和范围的起始值和终止值吗 谢谢啊
select secucode, buybackmoney from lc_buyback where strftime('%Y', advancedate) >= '2019' ;	ccks_stock	列出2019年以来，所有上市公司的股份回购总金额和股票代码 感谢
select claimsonotherdepositcorp, claimsonotherresidentsec from ed_otherdepositorycorpbs where totalassets > 50000000;	ccks_macro	在其他存款性公司资产负债表中，当总资产金额超过5千万的时候，我们的对其他存款性公司债权和对其他居民部门债权有多少
select b.chinesename from mf_managerexperience a join mf_personalinfo b on a.personalcode = b.personalcode group by b.chinesename order by count(*) desc limit 1	ccks_fund	任职段数最多的基金经理
select secuabbr,manager from mf_fundarchives where investstyle='大盘价值股票';	ccks_fund	看下投资风格是大盘价值股票的基金及基金经理
select a.secuabbr, a.riskreturncharacter from mf_fundarchives as a join mf_fundrisklevel as b on a.innercode = b.innercode where b.risklevel = '中'	ccks_fund	基金风险等级为"中"的基金名称和风险收益特征
select organizationform, count(*) from mf_investadvisoroutline group by organizationform;	ccks_fund	哥，按照基金公司组织形式进行归类，各有多少家
select b.leadername, b.positiondescription from lc_stockarchives as a join lc_executivesholdings as b on a.companycode = b.companycode where a.state = '浙江省' and b.secucode like '300%'	ccks_stock	看一下浙江省股票代码以300开头公司高管名称及职位 谢谢啊
select localgovrevenue, localgovexpenditure from ed_financialbalance where province ='上海';	ccks_macro	找一下数据。请提供一下上海市历年的地方财政收入和地方财政支出
select secuabbr from mf_mainfinancialindexq  where strftime('%Y', enddate)='2020' and round(strftime('%m',enddate)/3.0 + 0.495) = 4 and netassetsvalue > 10000000000	ccks_fund	2020年第四季度期末资产净值超过百亿的基金有哪些
select count(*) from lc_stockarchives where state='山西省'; 	ccks_stock	有山西省的上市公司数量信息吗
select chinameabbr from lc_ashareseasonednewissue  where strftime('%Y', advancedate)='2022';	ccks_stock	2022年以来有哪些公司增发股票了
select chinameabbr from lc_exgindustry where firstindustryname = '建筑业'	ccks_stock	帮我找一下数据！一级行业为"建筑业"的公司有哪些？
select secuabbr from mf_fundrisklevel where risklevel = '中高'	ccks_fund	筛选出所有风险等级为"中高"的基金代码 谢谢
select totalprofit from mf_mainfinancialindexq  where secuabbr = '华夏50ETF' and strftime('%Y', enddate)='2021' and round(strftime('%m',enddate)/3.0 + 0.495) = 1	ccks_fund	华夏50ETF2021年第一季度的利润是多少
select businessmajor from lc_business lb where chinameabbr ='南华生物'	ccks_stock	听说最近医药生物板块成交活跃，我想知道南华生物的主要经营范围，
select rrintenyear from mf_netvalueperformancehis ;	ccks_fund	我能看一下基金的十年回报率数据吗
select shname from lc_largeshsubscription where chinameabbr='亚泰集团' order by actualshares desc limit 1;	ccks_stock	展示一下数据，亚泰集团实配股数最多的配股大股东
select state, city from lc_stockarchives where state='湖南省' and city='长沙市';	ccks_stock	湖南省长沙市有多少企业
select chinameabbr,avg(actualshares) from lc_largeshsubscription group by chinameabbr;	ccks_stock	帮我找找数据，每个公司及其平均配股数
select chinesename from mf_fmscaleanalysisn where totalfundnv < 1;	ccks_fund	展示一下数据，哪些基金经理管理总规模小于1亿元
select chinameabbr from lc_sharesfloatingschedule where secucode like '6%' order by totalashares desc limit 1	ccks_stock	快速找一下数据。股票代码6开头的公司，A股总股数最高的公司名称
select mainoperincome from lc_mainoperincome  where chinameabbr ='冰山冷热' and strftime('%Y', enddate)='2020'	ccks_stock	2020年冰山冷热的主营业务收入是多少
select investadvisorname from mf_fundarchives group by investadvisorname order by count(*) desc limit 1;	ccks_fund	管理基金数最多的基金公司
select shname,oughtshares from lc_largeshsubscription where chinameabbr='天山股份';	ccks_stock	帮我找找数据，天山股份的配股大股东及其应配股数分别是？
select b.manager from mf_benchmarkgrowthrate as a join mf_fundarchives as b on a.innercode=b.innercode order by a.benchgrfor3month desc limit 10;	ccks_fund	三个月基金基准增长率排名前十的基金经理
select shname, holdingsum from lc_relatedsh where chinameabbr ='力源信息' ;	ccks_stock	力源信息的股东名称和股东持股比例是多少，帮我查一下啦
select count(*) from lc_stockarchives where city='武汉市';	ccks_stock	武汉市有几家上市公司
select collectiveunits, selfemployed from ed_retailvalueofscgoods  where reportarea ='省市' and reportperiod ='期末累计' and strftime('%Y', enddate) = strftime('%Y', DATE('now', '-1 year')) ;	ccks_macro	你好，查一下，各"省市"去年，集体单位和个体单位的"期末累计"社会消费品零售额
select bondabbr from mf_bondportifoliodetail where secuabbr='鹏华价值' and holdvolume>50000;	ccks_fund	哥，鹏华价值持有超过5万张的债券是那些
select retailvalueofscgoods from ed_retailvalueofscgoods where province ='北京';	ccks_macro	嗨，夏利呀，给我展示一下历年来，北京市的额社会消费品零售总额
select retailvalueofscgoods from ed_retailvalueofscgoods where province ='北京' and reportperiod ='期末累计';	ccks_macro	你好，北京市历年来的"期末累计"社会消费品零售总额是多少
select interestexpense, exchangeproloss from lc_financialexpense  where chinameabbr = '万达信息' and strftime('%Y', enddate)>'2016'	ccks_stock	列出万达信息2016年以后利息支出和汇兑损益具体数值 谢谢啊
select enddate,  subjectsum from ed_newincreasingloan where reportperiod ='月份' and subjectsum > 150000;	ccks_macro	请统计一下按"月份"记录的数据里，人民币新增贷款金额超过15万的记录，展示时间和新增金额字段
select chiname, shinvestsum from lc_relatedsh  where chinameabbr = '常山北明' and strftime('%Y', enddate)='2020' and strftime('%m', enddate )='3'	ccks_stock	2020年3月常山北明的股东及投资金额是多少
select agriculturaldeposits, savingsdeposits from ed_chinafibalancesheetrmb; 	ccks_macro	算一下我国信贷收支表中，农业存款总额是多少，储蓄存款总额是多少
select a.chinameabbr, a.fpshname from lc_sharefpsta as a join lc_exgindustry as b on a.companycode = b.companycode where b.firstindustryname = '建筑业' order by a.accuproportion desc	ccks_stock	列出公司所属一级行业为"建筑业"的公司简称和冻结质押股东名称，按累计占总股本比例倒序展示
select secuabbr,benchgrforthismonth from mf_benchmarkgrowthrate where benchgrforthismonth>5;	ccks_fund	列出本月以来基金基准增长率大于5%的基金及具体数值
select count(*) from lc_mainoperincome  where strftime('%Y', enddate)='2020' and grossprofit > 1	ccks_stock	2020年主营业务毛利率大于1的公司有多少个
select rrinselectedmonth from  mf_netvalueperformancehis ;	ccks_fund	请展示一下各个基金本月以来的回报率值
select secuabbr from mf_bondportifoliodetail where bondabbr='华海转债' and holdvolume>1000000;	ccks_fund	找出所有持有华海转债超过100万张的基金 谢谢啊
select a.chinameabbr from lc_mainoperincome as a join lc_stockarchives as b on a.companycode = b.companycode   where strftime('%Y', a.enddate)='2020' and b.state = '浙江省' order by  a.mainoperincome desc limit 1;  	ccks_stock	2020年浙江省内主营业务收入最多的公司是哪家 谢谢
select count(distinct chinameabbr) from qt_monthdata where strftime('%Y', enddate)='2022' and round(strftime('%m',enddate)/3.0 + 0.495)=1 and closeprice<2;	ccks_stock	统计一下有几只股票在2022年一季度的月收盘价低于2？
select chiname, count(*) from lc_sharefp  where strftime('%Y', enddate)='2020' and strftime('%m', enddate)='3' group by  chiname 	ccks_stock	统计2020年3月各公司股权被冻结股东数量
select underwritingsum from lc_issueandlistagent where chinameabbr='常山北明';	ccks_stock	嘿，常山北明股票发行上市时中介的承销金额是多少
select officeaddr from mf_investadvisoroutline where investadvisorabbrname = '建信基金';	ccks_fund	建信基金在哪里办公 谢谢啊
select max(retailvalueofscgoods) from ed_retailvalueofscgoods where province='上海' and reportperiod ='期末累计' ;	ccks_macro	展示一下上海市"期末累计"社会消费品零售总额的最大值
select secuabbr from mf_netvalueperformancehis where rrinsinglemonth > 5 and rrinsingleweek > 3;	ccks_fund	快速找一下数据。SIRI，基金产品筛选一下，一个月回报率超过5%，而且一周回报率超过3%
select totalaumrank from mf_fcretscalerank where abbrchiname='中信证券';	ccks_fund	查下中信证券总管理规模同类排名
select authorizer,authorizedreceiver from lc_sharetrustee  where strftime('%Y', infopubldate)='2019' and chinameabbr='诺德股份';	ccks_stock	2019年诺德股份的股权授权与接收方
select reserveassets  from ed_otherdepositorycorpbs ;	ccks_macro	您好，请展示一下其他存款性公司资产负载表中，储备资产的金额记录
select netassetsvalue from mf_mainfinancialindexq where secuabbr = '南方积配' order by enddate desc limit 1	ccks_fund	请问南方积配最新一季的期末基金资产净值
select chinesename from mf_personalinfo where education = '博士'  and gender = '男' and chinesename like '李%'	ccks_fund	列一下男性、博士，且姓李的基金经理
select bondfundn,bondfundnv from mf_fmscaleanalysisn where chinesename='陈龙';	ccks_fund	列一下陈龙管理的债券型基金数量和规模
select primaryindustrygdp, secondindustrygdp, thirdindustrygdp from ed_grossdomesticproduct ;	ccks_macro	帮我找一下数据！李工想了解一下我国每年的第一产业，第二产业和第三产业的国内生产总值金额
select abbrchiname,avgaumtypeavg from mf_fcretscalerank order by avgaumrank limit 1;	ccks_fund	我想了解一下数据情况。找一下平均管理规模排名第一的基金及其平均管理规模同类均值是多少
select max(closeprice) from qt_monthdata where chinameabbr = '东方电子'	ccks_stock	帮我查一下东方电子历史最高月度收盘价 谢谢
select expenditurecitymc from ed_financialbalance  where province ='北京' and strftime('%Y', enddate) = strftime('%Y', DATE('now', '-2 year')) ;	ccks_macro	前年北京市的城市维护建设费投入是多少
select fundsholdpropa from lc_stockholdingst  where strftime('%Y', enddate)='2020' and strftime('%m', enddate)='6' and chinameabbr='中航重机';	ccks_stock	2020年6月基金持有的中航重机的非限售流通股比例
select astockcode from lc_stockarchives where chinameabbr='康盛股份';	ccks_stock	查下康盛股份的股票代码
select secuabbr from mf_benchmarkgrowthrate where benchgrfor10year>200;	ccks_fund	有哪些基金的十年基金基准增长率超过200%
select aquiredsum , aquireramount from lc_legaldistribution where aquirername ='林泗华' ;	ccks_stock	有么有叫"林泗华"的人参与股份配售呀，有的话列出配售数量和获配金额
select holdproportionpaccount from lc_shnumber  where strftime('%Y', enddate)='2019' and round(strftime('%m',enddate)/3.0 + 0.495)=1 and chinameabbr='东旭蓝天';	ccks_stock	2019年1季度东旭蓝天的户均持股比例
select avg(a.annualizedrrsincestart) from mf_netvalueperformancehis as a join mf_fundarchives as b on a.innercode = b.innercode and b.fundtype ='股票型' ;	ccks_fund	能计算下"股票型"基金设立以来年化回报率均值吗 谢谢
select linkman from mf_investadvisoroutline where investadvisorabbrname = '南方基金';	ccks_fund	展示一下南方基金的联系人是谁
select businessminor from lc_business lb where chinameabbr ='深科技'	ccks_stock	hello,深科技的兼营范围是什么
select a.name from mf_fundmanagernew as a join mf_personalinfo as b on a.personalcode = b.personalcode where a.performance > 0 and b.experiencetime < 2	ccks_fund	基金经理从业年限小于2年且任职期间基金增长率为正的有哪些？
select basiscode , ratiofloor, ratioceiling from ed_taxrate where typename ='企债质押式回购' and itemname = '经手费' ;	ccks_macro	我想知道"企债质押式回购"的回购期限是多久，"经手费"缴纳的最低比率和最高比率分别是多少 谢谢啊
select a.state , count(*) from lc_stockarchives as a join lc_business as b on a.companycode = b.companycode where b.industryname ='专业技术服务业' group by a.state order by count(*) desc limit 1 ;	ccks_stock	帮我查一下这些数据。"专业技术服务业"行业中，上市公司最多的省份是哪个，列出省份名称
select socialsecufundholdpropa from lc_stockholdingst  where strftime('%Y', enddate)='2020' and strftime('%m', enddate)='5' and chinameabbr='奥普光电';	ccks_stock	2020年5月份社保持有的奥普光电的非限售售流通股比例
select sponsorname,lawfirm,accountingfirm from lc_ipodeclaration where secucode='300278';	ccks_stock	找下300278ipo的保荐机构、律所和会计所
select leadername from lc_executivesholdings where chinameabbr = '越剑智能' and shareamountbeginning > 10000000	ccks_stock	越剑智能初期持股数超过1000万的高管有哪些？
select evalagent from lc_ipodeclaration where chinameabbr='福斯特';	ccks_stock	福斯特在ipo时的评估机构是哪个
select count(*) from mf_fundmanagernew where performance < 0	ccks_fund	同学你好！任职期间基金增长率为负的基金经理有多少位？
select a.chinameabbr, b.legalrepr from lc_sharesfloatingschedule as a join lc_stockarchives as b on a.companycode = b.companycode where a.proportion2 > 20	ccks_stock	快速找一下数据。筛选已流通A股占A股总数比例超过20%的公司的公司名称、法人
select chinesename, qdiin, qdiinv from mf_fmscaleanalysisn where chinesename = '徐猛' or chinesename = '范冰';	ccks_fund	对比一下徐猛和范冰两位大佬管理的qdii基金数和规模 谢谢
select max(indexvalue) from ed_producerpiformp  where indexname ='纺织业' and reportperiod ='上年同期' and strftime('%Y', enddate) = strftime('%Y', DATE('now', '-1 year'));	ccks_macro	帮王工查一下，去年，"纺织业""上年同期"的指数值最大是多少
select actualshares from lc_largeshsubscription where shname='杉杉集团';	ccks_stock	杉杉集团作为配股大股东的实际配股记录
select fullname,legalpersonrepr from lc_issueandlistagent where chinameabbr='东阿阿胶';	ccks_stock	哥，查询东阿阿胶股票发行聘请的机构及其法人代表
select b.secuabbr, a.rrinsingleyear, a.rrintwoyear from mf_netvalueperformancehis as a join mf_fundarchives as b on a.innercode = b.innercode where b.fundtype = '债券型';	ccks_fund	过滤出债券型基金产品的一年、两年回报率数据
select financedeposits from ed_chinafibalancesheetrmb; 	ccks_macro	快速找一下数据。历年金融机构信贷收支记录中，财政性存款有多少
select secuabbr from mf_fundreturnrank where indexcycle = '六个月' order by fundreturn desc limit 1	ccks_fund	找出指标周期为"六个月"的基金收益率最高的基金名称
select a.fundannreturnmean from mf_fundreturnrank as a join mf_fundarchives as b on a.innercode = b.innercode where b.type = 'LOF'	ccks_fund	基金运作方式为LOF的基金对应的同类基金年化收益率均值
select a.chinameabbr from lc_sharestru as a join lc_exgindustry as b on a.companycode = b.companycode where b.firstindustryname = '制造业' order by a.afloats desc limit 20	ccks_stock	制造业A股股本排名前20的公司有哪些？
select bondabbr from mf_bondportifoliodetail where secucode='166001';	ccks_fund	把166001持仓的债券给我找一下 谢谢啊
select count(*) from lc_buyback  where strftime('%Y', advancedate)='2021' ;	ccks_stock	有多少家公司2021年进行股份回购
select investadvisorabbrname from mf_investadvisoroutline where legalrepr like '周%';	ccks_fund	查出那些企业法人姓周的基金公司
select education, gender, count(*) from mf_personalinfo group by education, gender;	ccks_fund	我想了解一下数据情况。按照学历水平和性别统计相应基金经理数量
select shname, max(actualshares) from lc_largeshsubscription where strftime('%Y', initialinfopubldate)>'2018' group by shname;	ccks_stock	快速找一下数据。2018年后每个股东的最大配股数
select fcdeposits , netabroadassets from ed_chinamoneyandbanking  where strftime('%Y', enddate) = strftime('%Y', DATE('now', '-2 year')) ;	ccks_macro	帮我查一下前年我国外币存款和国外净资产的详细信息 谢谢啊
select annualizedrrintwoyear , annualizedrrintenyear from mf_netvalueperformancehis ;	ccks_fund	请展示一下基金两年年化收益率和十年年化回报率
select authorizer from lc_sharetrustee  where strftime('%Y', infopubldate)='2014' order by  involvedtrustsum desc limit 1;	ccks_stock	展示一下数据，2014年授权最多股权的机构是哪个
select chargeratetydes , chargeratedes from mf_chargeratenew where secucode ='501065';	ccks_fund	请给我列出501065的费率类型，以及费率描述
select max(totalassets), min(totalassets) , max(totalliabilities), min(totalliabilities)  from ed_otherdepositorycorpbs;	ccks_macro	展示一下数据，统计一下，在其他存款性公司资产负债表中，总资产和总负债的最大最小值
select b.firstindustryname, count(*) from lc_sharesfloatingschedule as a join lc_exgindustry as b on a.companycode = b.companycode where a.proportion2 > 60 group by b.firstindustryname	ccks_stock	已流通A股占A股总数比例超过60%的公司有多少家，按一级行业分组展示
select  aquirername from lc_legaldistribution  where aquiredsum > 10000 and strftime('%Y', infopubldate) = strftime('%Y', DATE('now', '-1 year'));	ccks_stock	找一下数据。上一年配售股份超过1万分的投资者有哪些
select  maturity,  ratiofloor, ratioceiling from ed_taxrate where typename ='国债买断式回购' and itemname ='经手费' ; 	ccks_macro	搜一下"国债买断式回购"不同的回购期限，"经手费"的最高比率和最低比率分别是多少
select enddate, hivalueap from ed_industryproduction where reportarea ='全国' and statstandard ='国有及规模以上工业企业' and reportperiod ='月度';	ccks_macro	你知道咱们数据库里，历年的"全国""国有及规模以上工业企业"中，重工业的"月度"工业生产总值金额吗
select insurancecorpsholdpropa from lc_stockholdingst where chinameabbr='恒生电子';	ccks_stock	保险公司持有恒生电子非限售流通股比例是多少
select turnoverdeals from qt_dailyquote where secucode = '601908';	ccks_stock	展示601908每个交易日的成交笔数数据 谢谢啊
select a.name from mf_fundmanagernew as a join mf_fundarchives as b on a.innercode = b.innercode where b.fundtype = '股票型'	ccks_fund	基金类别为"股票型"基金的在任基金经理有哪些？ 谢谢
select rrsincethisyear from mf_netvalueperformancehis ;	ccks_fund	嘿，请帮我查一下各基金今年以来回报率大小
select count(*) from lc_legaldistribution  where aquiredsum > 10000 and strftime('%Y', infopubldate) = strftime('%Y', DATE('now', '-1 year'));	ccks_stock	去年配售股份超过1万份的投资者有多少
select b.city, count(*) from lc_coconcept as a join lc_stockarchives as b on a.companycode = b.companycode where a.conceptname ='OLED' group by b.city ; 	ccks_stock	统计一下"OLED"这个板块的股票，都集中在哪些城市，列出城市名称和数量
select secucode, chinameabbr from lc_buyback  where buybacksum > 100000 and strftime('%Y', advancedate) > strftime('%Y', DATE('now', '-2 year'));	ccks_stock	近两年单次回购股份总分数超过10万份的公司有哪些，列出公司名称和代码
select nvdailygrowthrate, rrinselectedweek, rrinsingleweek from mf_netvalueperformancehis where secuabbr = '华宝宝盛';	ccks_fund	万能的机器人，帮我查一下华宝宝盛这支基金的日回报率、本周以来回报率和一周回报率指标数据 谢谢
select enddate, retailvalueofscgoods from ed_retailvalueofscgoods where province ='上海' and reportperiod ='年度' and strftime('%Y', enddate)<'2010';	ccks_macro	那2010年以前，我们社会消费品销售总额有记录吗，有的话展示一下上海市每年的"年度"总金额
select b.secuabbr,b.fundtype from mf_bondportifoliodetail as a join mf_fundarchives as b on a.innercode=b.innercode where a.bondabbr='海亮转债';	ccks_fund	找下哪些基金持有海亮转债，其基金类型是什么
select enddate, industrialvalueadded from ed_industryproduction where reportarea ='全国' and statstandard ='国有及规模以上工业企业' and reportperiod ='期末累计';	ccks_macro	请列出每年全国的国有及规模以上工业企业的期末累计工业增加值
select count(*) from lc_ashareseasonednewissue  where strftime('%Y', advancedate) > strftime('%Y', DATE('now', '-5 year'));	ccks_stock	帮我找一下数据！最近5年发生过多少次股票增发呀
select chiname from mf_fundarchives where secuabbr='博时主题';	ccks_fund	嘿，博时主题的全称
select wholesaleretailtrade , foodbeverage from ed_retailvalueofscgoods ;	ccks_macro	展示一下我国批发零售贸易业和餐饮业的数据记录 谢谢啊
select moneyreserves , selfownedmoney from ed_moneyauthoritybs  where strftime('%Y', enddate) = strftime('%Y', DATE('now', '-2 year')) ;	ccks_macro	请展示一下前年，货币当局资产负债表中，储备货币和自有资金的记录
select chiname, holdingsum from lc_relatedsh  where chinameabbr = '航天发展' and strftime('%Y', enddate)='2020' and strftime('%m', enddate )='3'	ccks_stock	帮我查一下2020年3月航天发展的股东及持股数量
select authorizer from lc_sharetrustee  where strftime('%Y', infopubldate)='2018' and chinameabbr='新北洋';	ccks_stock	2018年新北洋的股权有哪些授权方
select a.state, count(*) from lc_stockarchives as a join lc_sharestru as b on a.companycode = b.companycode where b.nonlistedshares > 200000000 group by a.state	ccks_stock	未流通A股股数超过2亿的公司有多少家，按公司所在省份分组
select a.industryname , count(*) from lc_business as a join lc_stockarchives as b on a.companycode = b.companycode  where strftime('%Y', b.establishmentdate)='2010' group by  a.industryname having count(*)>10;	ccks_stock	你好，列出2010年成立的上市公司数量达到10家的行业名称，别列出对应的上市公司数量
select avg(b.totalfundnv) from mf_personalinfo as a join mf_fmscaleanalysisn as b on a.personalcode = b.personalcode where a.experiencetime < 5;	ccks_fund	从业经验小于5年的基金经理平均管理了多少价值的基金
select flochargerate , divintervaldes  from mf_chargeratenew where secuabbr ='富国创新药ETF';	ccks_fund	我想知道"富国创新药ETF"的费率计算方式是什么，还有他的费率划分区间描述
select ratioceiling from ed_taxrate where typename ='A股' and itemname = '证券交易印花税' and secumarket ='深圳证券交易所' ;	ccks_macro	请列出"A股"在"深圳证券交易所"的"证券交易印花税"的最高缴纳比例是多少哦 感谢
select nationality, count(*) from mf_personalinfo group by nationality	ccks_fund	基金经理的国籍统计情况
select count(*) from lc_legaldistribution  where strftime('%Y', infopubldate)='2021';	ccks_stock	帮我统计下2021年有几家公司有配售股票的记录
select b.nationality from mf_fmperfanalysis as a join mf_personalinfo as b on a.personalcode = b.personalcode where a.annsharper > 2 group by b.nationality having count(*) > 20	ccks_fund	基金经理管理基金的年化夏普比率超过2，基金经理人数超过20的国籍有哪些？
select count(*) from lc_freefloat  where totalashare > 10000000000 and strftime('%Y', changedate)='2021'	ccks_stock	2021年A股总股本超过100亿的公司共计几家？
select fundmanager , fund from mf_awards where appraisalorgcode = '40981';	ccks_fund	"40981"这家机构给哪些基金经理颁发过奖项，还有对应的基金名称也列一下 感谢
select  secucode from lc_relatedsh  where shname ='顾瑜' and shinvestsum > 1000000 and strftime('%Y', enddate) = strftime('%Y', DATE('now', '-1 year'));	ccks_stock	帮我看一下"顾瑜"去年持有的股票中，哪些股票的投资金额超过了1百万
select a.state , count(*) from lc_stockarchives as a join lc_business as b on a.companycode = b.companycode where b.industryname ='农业' group by a.state ;	ccks_stock	听说东北是农业大省，帮忙看看"农业"行业的上市公司中，各省份的数量是多少
select count(*) from mf_bondportifoliodetail where secuabbr='博时主题';	ccks_fund	哥，有多少债券是博时主题重仓的债券
select a.secucode, a.chinameabbr from lc_coconcept as a join lc_stockarchives as b on a.companycode = b.companycode where a.conceptname ='集成电路' and b.city ='西安市';	ccks_stock	siri, 能给我分类统计下，"西安市"有哪些上市公司市"集成电路"板块的
select socialsecufundholdpropa from lc_stockholdingst  where strftime('%Y', enddate)='2019' and strftime('%m', enddate)='2' and chinameabbr='中航重机';	ccks_stock	2019年2月份社保持有的中航重机的无限收流通a股份比例是多少
select chinesename from mf_personalinfo where strftime('%Y', birthdate)>'1990';	ccks_fund	展示一下数据，1990年以后出生的基金经理有吗？
select numberoffunds from mf_fmretscaleanalysis where chinesename = '付浩';	ccks_fund	请问，基金经理付浩管理的基金数量
select max(indexvalue), min(indexvalue) from ed_producerpiformp  where indexname ='食品制造业' and reportperiod ='上年同期' and strftime('%Y', enddate)='2008' ;	ccks_macro	展示一下"上年同期"统计类型中，2008年至今，"食品制造业"的最大和最小指数值
select buybacksum, percentage, buybackmoney from lc_buyback where chinameabbr = '浙江龙盛' ;	ccks_stock	展示一下浙江龙盛的股份回购情况，包括回购数量，占比和回购总金额
select rrinfiveyear from mf_netvalueperformancehis ;	ccks_fund	搜一下基金的五年回报率结果数据
select claimstogov, claimstononfinancialinst, claimstospecificsavingorg from ed_chinamoneyandbanking ;	ccks_macro	历史上，我们对政府债权、对非金融部门债权、特定存款机构的债权分别是多少哦
select indexname, indexvalue from ed_producerpiformp where reportperiod ='上年同月' and indextype ='工业结构分类指数';	ccks_macro	请回答一下，"工业结构分类指数"中，"上年同月"各类指数名称及其指数值 谢谢啊
select firstindustryname from lc_exgindustry where chinameabbr = '普路通'	ccks_stock	普路通的一级行业是什么？
select secuabbr from mf_bondportifoliodetail where bondcode='200203';	ccks_fund	有基金持有200203吗
select province, primaryindustrygdp, secondindustrygdp, thirdindustrygdp from ed_grossdomesticproduct  where strftime('%Y', enddate) = strftime('%Y', DATE('now', '-2 year') ) ;	ccks_macro	前年，各个省份的第一产业、第二产业和第三产业国内生产总值分别是多大
select nvdailygrowthrate from mf_netvalue where secuabbr = '华安石油A';	ccks_fund	你能帮我找到华安石油A的开放基金单位净值日增长比例吗？
select  secucode from lc_sharefp  where strftime('%Y', enddate) > strftime('%Y', DATE('now', '-2 year'));	ccks_stock	最近两年，有哪些股票被冻结质押过，列出股票代码
select enddate, claimsongovernment, claimsoncentralbank from ed_otherdepositorycorpbs where totalassets > 30000000;	ccks_macro	帮忙列出在其他存款性公司资产负债表中，当总资产金额超过3千万时，对政府债权和对中央银行债权的金额分别是多大，并用时间区分
select bondabbr,marketvalue,ratioinnv from mf_bondportifoliodetail where secucode='161010';	ccks_fund	列一下161010的持仓债券、市值和占净资产比例情况
select aquirername from lc_legaldistribution where secucode = '002981';	ccks_stock	002981的投资者有哪些
select chinesename from mf_fmscaleanalysisn where bondfundn>3;	ccks_fund	管理债券型基金数量高于3个的基金经理有谁
select  chinameabbr from lc_legaldistribution  where strftime('%Y', infopubldate) = strftime('%Y', DATE('now', '-1 year')) ;	ccks_stock	帮我看看去年有哪些公司有配售股票的记录
select secondindustryname from lc_exgindustry where firstindustryname = '信息传输、软件和信息技术服务业' group by secondindustryname order by count(*) desc limit 2	ccks_stock	可以告诉我，一级行业为"信息传输、软件和信息技术服务业"，二级行业公司数量排名前2的行业名称
select state, city from lc_stockarchives where chinameabbr='华昌达';	ccks_stock	华昌达的所在省市
select  aquirername from lc_legaldistribution  where strftime('%Y', infopubldate)='2020'	ccks_stock	帮我查一下2020年国网英大获配企业有哪些
select enddate, nvweeklygrowthrate from  mf_netvalue  where strftime('%Y', enddate) > strftime('%Y', DATE('now', '-2 year')) and secucode ='160416' ;	ccks_fund	你好啊，能给我查一下160416这只基金最近2年的单位基金净值周增长率吗
select b.fundtype from mf_netvalueperformancehis as a join mf_fundarchives as b on a.innercode = b.innercode group by b.fundtype order by avg(a.rrinsinglemonth) desc limit 1;	ccks_fund	展示一下数据，哪个基金类别的产品一个月回报率平均值最大
select annualizedrrintwoyear from mf_netvalueperformancehis ;	ccks_fund	帮我搜索一下基金的二年年化回报率吧
select a.bondabbr,a.marketvalue, b.manager from mf_bondportifoliodetail as a join mf_fundarchives as b on a.innercode=b.innercode where a.secucode='510130';	ccks_fund	看下510130的债券持仓、市值和基金经理等信息 谢谢啊
select abbrchiname from mf_fcretscalerank where fundtypename='债券型' order by totalaumtypeavg desc limit 10;	ccks_fund	找一下数据。列出哪十个债券型基金的总规模管理规模同类均值最高
select a.secuabbr, a.briefintro from mf_fundarchives as a join mf_fundrisklevel as b on a.innercode = b.innercode where b.risklevel = '中高'	ccks_fund	基金风险等级为"中高"的基金名称和基金简介
select b.secuabbr,b.manager,a.benchgrfor6month from mf_benchmarkgrowthrate as a join mf_fundarchives as b on a.innercode=b.innercode where a.benchgrfor6month>0;	ccks_fund	列出六个月基金基准增长率为正的基金、经理和具体值
select b.state from lc_mainoperincome as a join lc_stockarchives as b on a.companycode = b.companycode where a.mainoperincome > 100000000000;  	ccks_stock	主营业务收入超过1000亿元的公司都分布在哪些省份 谢谢啊
select csrcindustryname,count(*) from lc_ipodeclaration  where strftime('%Y', enddate)='2012' group by  csrcindustryname;	ccks_stock	2012年各行业进行ipo的公司的数量分别是多少 感谢
select a.name, b.education from mf_fundmanagernew as a join mf_personalinfo as b on a.personalcode = b.personalcode where a.performance < 0.1	ccks_fund	基金净值增长率小于0.1的基金经理名称及学历
select enddate, province, industrialvalueadded from ed_industryproduction where reportarea = '省市' and statstandard ='国有及规模以上工业企业' and reportperiod ='年度' ;	ccks_macro	统计一下各"省市"的"国有及规模以上工业企业"中，每年的"年度"工业增加值金额
select sponsorname, lawfirm from lc_ipodeclaration where chinameabbr='红塔证券' order by enddate desc limit 1; 	ccks_stock	展示一下数据，红塔证券最新的保荐人和ipo律所
select fpshname from lc_sharefp where chinameabbr = '瑞茂通' and involvedsum > 1000000 ;	ccks_stock	方便查一下瑞茂通的股权冻结质押中，冻结数量超过1百万的股东名称吗
select stockabbr from mf_keystockportfolio where stockabbr is not null group by  stockabbr order by count(*) desc limit 1	ccks_fund	被最多基金持有的股票是哪只
select rrsincestart from mf_netvalueperformancehis ;	ccks_fund	你知道基金设立以来回报率是多大吗
select secuabbr,riskreturncharacter from mf_fundarchives where investstyle='行业股票-医药';	ccks_fund	列出所有“行业股票-医药风格”的基金及风险收益特征
select enterpriseincome, enterpriseincometax from ed_financialbalance  where genterpriseincome > 5 and province ='北京' and strftime('%Y', enddate) > strftime('%Y', DATE('now', '-5 year')) ;	ccks_macro	你好，王总来视察了，帮忙提取出北京市近五年的企业增速收入超过5时，企业收入和企业所得税的记录
select annualizedrrintenyear , annualizedrrsincestart  from mf_netvalueperformancehis ;	ccks_fund	还有哦，小李，帮忙查一下基金十年年化收益率和设立以来年化回报率
select a.education, avg(b.totalfundnv) from mf_personalinfo as a join mf_fmscaleanalysisn as b on a.personalcode = b.personalcode group by a.education;	ccks_fund	你好，统计不同学历水平的基金经理管理基金总规模平均数分布情况
select b.education, count(*) from mf_fmperfanalysis as a join mf_personalinfo as b on a.personalcode = b.personalcode where a.annalphacoef > 0.5 group by b.education	ccks_fund	基金经理管理基金的年化阿尔法超过0.5的有多少位，按基金经理学历分组展示
select province from ed_grossdomesticproduct  where strftime('%Y', enddate) = strftime('%Y', DATE('now', '-1 year')) and gdpgrowthyoy > 0.5;	ccks_macro	我想看看去年，国内生产总值同比超过0.5的省份名单
select mainoperincome from lc_mainoperincome  where chinameabbr='中国石化' and strftime('%Y', enddate) = strftime('%Y', DATE('now', '-1 year')) and round(strftime('%m',enddate)/3.0 + 0.495) = 1 ;	ccks_stock	我想了解一下数据情况。中石化去年一季度的主营业务成本是多少
select enddate, livalueap from ed_industryproduction where reportarea ='全国' and statstandard ='全部工业企业' and reportperiod ='期末累计';	ccks_macro	siri, 请帮我查一下历年来，"全国""全部工业企业"范围内，轻工业的"期末累计"工业生产总值数据
select unitnv , nvweeklygrowthrate from  mf_netvalue ;	ccks_fund	嘿，你知道各个基金的单位净值和周增长率是多少吗
select chinesename from mf_fmscaleanalysisn order by qdiinv desc limit 1;	ccks_fund	谁管理的QDII基金规模最大 感谢
select count(*) from lc_buyback  where strftime('%Y', advancedate)='2021' ;	ccks_stock	统计一下2021年有多少家上市公司进行过股份回购
select chinameabbr from qt_monthdata  where strftime('%Y', enddate)='2020' group by  chinameabbr order by max(totalshare) desc limit 10;	ccks_stock	月度数据中2020年总股本排名前十的股票
select chinesename, equityfundn, equityfundnv from mf_fmscaleanalysisn where equityfundn > 5;	ccks_fund	找到所有管理了超过5支股票型产品的基金经理，并展示相应的基金数量和总规模 谢谢
select nvdailygrowthrate from  mf_netvalueperformancehis ;	ccks_fund	请搜索一下各个基金的的日回报率
select chinameabbr from lc_actualcontroller where nationalitydesc != '中国';	ccks_stock	找找哪些公司的实际控制人不是来自中国大陆
select proportiongrhalfayear from lc_shnumber where chinameabbr='兴业证券';	ccks_stock	兴业证券的户均持股比例半年增长率是多少
select mainopercost, mainoperprofit from lc_mainoperincome  where chinameabbr ='古井贡酒' and strftime('%Y', enddate)='2018';	ccks_stock	2018年以后，古井贡酒的主营业务利润是怎样的，列出主营业务成本和主营业务利润
select count(tradingday) from qt_dailyquote where chinameabbr = '科思股份' and turnovervalue > 100000000;	ccks_stock	统计一下科思股份有多少个交易日成交总金额超1亿元
select a.secuabbr, a.rrsincestart from mf_netvalueperformancehis as a join mf_fundarchives as b on a.innercode = b.innercode and b.fundtype ='债券型' ;	ccks_fund	展示一下"债券型"基金设立以来的回报率 谢谢
select divibase, cashdivirmb from lc_dividend  where chinameabbr ='深科技' and strftime('%Y', dividendimplementdate) > strftime('%Y', DATE('now', '-3 year'));	ccks_stock	深科技最近三年效益还行，它分红股本基数和派现金额是多少啊
select secuabbr from mf_keystockportfolio where stockabbr = '海康威视'	ccks_fund	哪些基金持有了海康卫视
select enddate,  subjectsum from ed_newincreasingloan  where reportperiod ='期末累计' and subjectsum > 150000 and strftime('%Y', enddate)>='2000';	ccks_macro	快速找一下数据。2000年以来，人民币新增金额超过15万的记录有哪些，请找出按照"期末累计"记录的时间，和贷款新增金额字段
select  secucode from lc_dividend  where bonusshareratio > 0.5 and strftime('%Y', dividendimplementdate) = strftime('%Y', DATE('now', '-1 year'));	ccks_stock	hello,帮我查一下去年送股比例超过0.5的上市公司代码
select chinameabbr from lc_financialexpense order by commission desc limit 1	ccks_stock	手续费最高的公司是哪家？
select enddate, totalassets  from ed_otherdepositorycorpbs order by totalassets desc limit 1;	ccks_macro	在我们的其他存款性公司资产负债表中，这些年来，总资产的最大值是多少，归属于哪一年 谢谢啊
select b.secuabbr,a.benchgrforthisweek from mf_benchmarkgrowthrate as a join mf_fundarchives as b on a.innercode=b.innercode   where b.type='LOF';	ccks_fund	哥，看下LOF基金本周以来基金基准增长率情况
select  ratioceiling from ed_taxrate where typename ='中资大型银行' and itemname = '超额存款准备金率'  ;	ccks_macro	"中资大型银行"的"超额存款准备金率"的最小比率是多少
select corporatesavings from ed_chinafibalancesheetrmb; 	ccks_macro	嘿，我朋友想知道咱们金融机构人民币信贷收支这些年的情况是什么样的，列出单位或者企业存款期末余额
select b.secuabbr from mf_benchmarkgrowthrate as a join mf_fundarchives as b on a.innercode=b.innercode  where b.type='LOF' and a.benchgrforthismonth>0;	ccks_fund	有LOF基金本月以来基金基准增长率为正吗
select imvalueofgoods , exvalueofgoods from ed_exportimport  where imvalueofgoods < 20 and exvalueofgoods > 40 and strftime('%Y', enddate) > strftime('%Y', DATE('now', '-3 year'));	ccks_macro	这三年来，我国出口金额超过4000万，进口金额低于2000万的出口金额和进口金额 感谢
select b.chinameabbr from lc_largeshsubscription as a join lc_stockarchives as b on a.companycode=b.companycode  where b.state='福建省' and a.oughtshares>1000000;	ccks_stock	福建省上市公司里有应配股数大于100万股的吗？
select domesticloans, fcdeposits from ed_chinamoneyandbanking where strftime('%Y', enddate)>='2005';	ccks_macro	给咱们搜一下2005年以后，国内信贷和外币存款的数据 感谢
select shname from lc_largeshsubscription where chinameabbr='浙大网新' order by actualshares desc limit 1;	ccks_stock	hello,浙大网新的最大实际配股大股东是谁
select a.avgaumtyperank from mf_fmretandscalerank as a join mf_personalinfo as b on a.personalcode = b.personalcode where b.education = '本科'	ccks_fund	你知道基金经理学历为本科的平均管理规模同类排名情况吗？
select chargeratetydes, chargeratedes from mf_chargeratenew where secuabbr ='南方天元' ;	ccks_fund	列出"南方天元"的费率类型，以及每种费率金额
select rightregdate , cashdivirmb from lc_dividend where cashdivirmb > 5 and chinameabbr = '古井贡酒';	ccks_stock	古井贡酒历年派现金额超过5块的记录有哪些，展示股权登记日和派现金额 谢谢啊
select a.name from mf_fundmanagernew as a join mf_personalinfo as b on a.personalcode = b.personalcode where a.managementtime > 200 and b.education = '博士'	ccks_fund	基金经理学历为博士且任职天数超过200天的有哪些？
select a.chinameabbr, b.leadername, b.positiondescription from lc_sharetransfer as a join lc_executivesholdings as b on a.companycode = b.companycode order by a.pctbeforetran desc limit 5	ccks_stock	出让前持股比例排名前5公司的公司名称、高管姓名及职位
select a.chinesename, b.practicedate from mf_fmperfanalysis as a join mf_personalinfo as b on a.personalcode = b.personalcode where a.indexcycle = '三年' order by a.calmarr desc limit 10	ccks_fund	指标周期为"三年",卡玛比率排名前10的基金经理姓名和证券从业日期
select firstindustryname, secondindustryname from lc_exgindustry where chinameabbr = '西藏发展'	ccks_stock	西藏发展的一级行业和二级行业分别是什么？
select b.type, count(*) from mf_fundreturnrank as a join mf_fundarchives as b on a.innercode = b.innercode where a.indexcycle = '六个月' and a.fundreturnmean < 0 group by b.type	ccks_fund	显示指标周期为"六个月"的同类基金收益率均值为负的基金数目，按基金运作方式分组展示
select chinameabbr, avg(turnovervalue) from qt_dailyquote  where strftime('%Y', tradingday)='2021' and round(strftime('%m',tradingday)/3.0 + 0.495) = 4 group by  chinameabbr;	ccks_stock	展示2021年第四季度各公司平均日成交总金额 谢谢
select benchgrforthismonth from mf_benchmarkgrowthrate where secuabbr='交银治理ETF';	ccks_fund	hello,查出交银治理ETF本月以来基金基准增长率
select unitnv, accumulatedunitnv, discountratio from mf_netvalue where secuabbr = '华安180ETF' ;	ccks_fund	列出基金产品华安180ETF的单位净值、累计净值和升贴水率情况
select moneyandquasimoney, money1, quasimoney from ed_chinamoneyandbanking  where strftime('%Y', enddate) > strftime('%Y', DATE('now', '-2 year')) ;	ccks_macro	展示一下这两年我国货币和准货币的总记录，以及货币和准货币分别是多少
select b.chinesename,b.birthdate from mf_fmscaleanalysisn as a join mf_personalinfo as b on a.personalcode=b.personalcode order by a.bondfundnv desc limit 10;	ccks_fund	查下债券型管理规模排名前十的基金经理和出生日期信息
select secuabbr from mf_mainfinancialindexq  where strftime('%Y', enddate)='2021' and round(strftime('%m',enddate)/3.0 + 0.495) = 1 and netassetsvalue > 10000000000	ccks_fund	siri, 2021年第一季度哪些基金期末资产净值超过百亿
select a.secondindustryname, count(*) from lc_exgindustry as a join lc_freefloat as b on a.companycode = b.companycode  where b.afloats > 10000000000 and strftime('%Y', changedate)='2019' group by  a.secondindustryname	ccks_stock	显示2019年流通A股股本超过100亿的公司数目，按公司所在二级行业分组统计
select b.nationality, count(*) from mf_fmretscaleanalysis as a join mf_personalinfo as b on a.personalcode = b.personalcode where a.avgaum > 500 group by b.nationality	ccks_fund	平均基金规模大于500亿元的基金经理国籍分布情况 谢谢啊
select moneyandquasimoney, money1, quasimoney from ed_chinamoneyandbanking  where strftime('%Y', enddate)<'1995';	ccks_macro	帮李处长查一下咱们1995年以前货币和准货币总金额是多少，货币、准货币金额分别是多少
select chinameabbr, tradingday from qt_dailyquote where turnovervalue > 1000000000;	ccks_stock	请问有哪些公司和成交日对应成交总额超过10亿
select chinameabbr from lc_stockarchives where legalrepr='张利忠';	ccks_stock	查下张利忠是哪个上市公司的法人代表 感谢
select otherforeignassets, otherliability from ed_moneyauthoritybs ;	ccks_macro	请帮我在货币当局资产负债表中查一下，其他国外资产和其他负债的数据分别是多少
select unitnv, nvdailygrowthrate from  mf_netvalue  where round(strftime('%m',enddate)/3.0 + 0.495) = round(strftime('%m',date()) / 3.0 + 0.495) and secuabbr ='华安石油A' ;	ccks_fund	我想了解一下数据情况。请展示一下"华安石油A"这只基金。这个季度的单位净值和日增长率
select city,count(*) from lc_stockarchives where state='陕西省' group by city order by count(*) desc limit 1; 	ccks_stock	陕西省哪个城市的上市公司最多，具体数目是多少
select secuabbr,holdvolume from mf_bondportifoliodetail where bondabbr='温氏转债';	ccks_fund	看下都是哪些基金持有温氏转债，且持有的数量分别是多少
select leadername, positiondescription from lc_executivesholdings where chinameabbr = '依米康'	ccks_stock	列出依米康的高管姓名及职位
select chiname from lc_relatedsh  where chinameabbr = '航天发展' and strftime('%Y', enddate)='2020' and strftime('%m', enddate )='8'	ccks_stock	2020年8月航天发展的股东有哪些 感谢
select prconfirmationdate from mf_fundarchives where secuabbr = '招商成长'	ccks_fund	嘿，招商成长的申赎确认日
select a.returntyperank from mf_fmretandscalerank as a join mf_personalinfo as b on a.personalcode = b.personalcode where b.experiencetime > 10	ccks_fund	帮我查一下这些数据。请问，证券从业经历超过10年的基金经理的同类经理收益率排名情况
select enddate, netabroadassets from ed_chinamoneyandbanking where netabroadassets > 1000000;	ccks_macro	哥，嘿，小李，能帮我查一下我国国外净资产超过1百万元的记录情况吗，给出日期和国外净资产金额的字段
select chinesename,totalfundnvrank from mf_fmscaleanalysisn;	ccks_fund	看下基金经理及总管理基金规模排名情况
select sponsorname from lc_ipodeclaration where accountingfirm='立信会计事务所';	ccks_stock	会计事务所是立信会计事务所的上市公司的ipo保荐人
select avg(rrinsingleyear) from mf_netvalueperformancehis;	ccks_fund	哥，帮我计算一下全市场基金产品一年回报率均值
select forex, moneyandgold, otherforeignassets from ed_moneyauthoritybs where totalassets > 10;	ccks_macro	请搜索一下，这些年来，我们总资产超过1千万时，外汇金额、货币黄金金额和其他国外资产的数据，
select leadername, positiondescription from lc_executivesholdings where chinameabbr = '福星股份' and leadername like '%谭%'	ccks_stock	我想了解一下数据情况。福星股份哪个高管的名字有"谭"这个子串？列出姓名和职位。
select loantogov, financedeposits from ed_chinafibalancesheetrmb  where strftime('%Y', enddate) > strftime('%Y', DATE('now', '-2 year')) ;	ccks_macro	这两年，我国金融机构信贷收支中，财政借款和财政性存款总额是多少
select b.secuabbr, b.risklevel from mf_fundmanagernew as a join mf_fundrisklevel as b on a.innercode = b.innercode where strftime('%Y', a.dimissiondate)<'2020'	ccks_fund	展示一下数据，返回离职日期在2020年以前的基金经理所管理的基金名称及基金风险等级
select a.secucode, b.state, b.city from lc_business as a join lc_stockarchives as b on a.companycode = b.companycode where a.industryname ='专业技术服务业';	ccks_stock	帮我找找数据，列出“专业技术服务业”的上市公司股票代码以及所在的省份和城市
select shnum,averageholdsum from lc_shnumber  where chinameabbr='新天然气' and strftime('%Y', enddate)='2016';	ccks_stock	新天然气2016年的总股东数和户均持股数
select enddate,  subjectsum, yoy from ed_newincreasingloan  where reportperiod ='月份' and subjectsum > 100000 and strftime('%Y', enddate) = strftime('%Y', DATE('now', '-2 year'));	ccks_macro	李工想问能不能给他显示下前年，有没有按"月份"记录的贷款新增金额超过了10万，有的话，请提取一下时间和贷款金额和同比增减记录
select b.chinameabbr from lc_stockarchives as a join lc_sharestru as b on a.companycode = b.companycode where a.state = '上海市' and b.afloats > 10000000	ccks_stock	上海市流通股本超过1000万的公司有哪些？ 谢谢啊
select chinameabbr, aquireramount from lc_legaldistribution  where aquirername ='广发估值优势混合型证券投资基金' and strftime('%Y', infopubldate) = strftime('%Y', DATE('now', '-1 year')) ;	ccks_stock	"广发估值优势混合型证券投资基金"上一年参与了哪些公司的股份配售，获配金额是多少
select nationalitydesc from lc_actualcontroller group by nationalitydesc order by count(*) desc limit 3;	ccks_stock	实际控制上市公司数量最多的前3国家或地区是哪些
select abbrchiname from mf_fcretscalerank where fundtypename='债券型' order by totalaumrank limit 10;	ccks_fund	嘿，债券型基金的总管理规模同类排名最高的十个
select a.chinesename, b.practicedate from mf_fmretandscalerank as a join mf_personalinfo as b on a.personalcode = b.personalcode where a.timeinterval = '近1天' order by a.avgaumtypeavg desc limit 1	ccks_fund	时间区间为"近1天"，平均管理规模同类均值最高的基金经理姓名和证券从业日期 感谢
select chinesename, bondfundn, bondfundnv from mf_fmscaleanalysisn order by bondfundnv desc limit 1;	ccks_fund	展示一下数据，债券型基金中，谁管理总规模最大，相应的基金数量和总规模分别是多少
select nvweeklygrowthrate from  mf_netvalue where secucode = '510220';	ccks_fund	王工说给他查一下510210的单位基金净值周增长率数据记录
select enddate, unitnv from mf_netvalue where secuabbr = '泰达效率';	ccks_fund	能帮我看一下"泰达效率"的单位净值吗，历年来的数据
select b.fundtype, count(*) from mf_netvalueperformancehis as a join mf_fundarchives as b on a.innercode = b.innercode where a.annualizedrrsincestart > 10 group by b.fundtype;	ccks_fund	同学你好！按照基金类别分组统计各自有多少设立以来年化回报超过10%
select leadername, chinameabbr from lc_executivesholdings where positiondescription like '%董事长%' and positiondescription like '%总裁%'	ccks_stock	找一下数据。告诉我，同时担任总裁和董事长的高管姓名及公司名称
select chinameabbr, secucode from lc_legaldistribution  where strftime('%Y', infopubldate) = strftime('%Y', DATE('now', '-1 year')) ;	ccks_stock	帮我查一下这些数据。最近一年有哪些公司有配售股票的记录，列出股票名称和股票代码
select chinameabbr from lc_sharesfloatingschedule where newmarketableashares <= 1000	ccks_stock	同学你好！本次新增可售A股股数不超过1000万股的公司有哪些
select count(distinct fundcompanycode) from mf_awards ;	ccks_fund	获得过奖项的公募基金公司有多少个 谢谢
select enddate, industrialvalueadded from ed_industryproduction where reportarea ='全国' and statstandard ='全部工业企业' and reportperiod ='月度';	ccks_macro	请列出"全国"范围内，"全部工业企业"的"月度"工业增加值数据，保留时间字段 感谢
select enddate, industrialoutputvalueap from ed_industryproduction where reportarea ='全国' and statstandard ='全部工业企业' and reportperiod ='月度';	ccks_macro	能算算"全国""全部工业企业"这些年来的"月度"工业总产值金额， 谢谢
select count(*) from lc_business as a join lc_stockarchives as b on a.companycode = b.companycode where b.state = '江苏省' and a.industryname ='农副食品加工业';	ccks_stock	找一下数据。能给我查一下"江苏省""农副食品加工业"有多少家上市公司吗
select enddate, forex, moneyandgold, otherforeignassets from ed_moneyauthoritybs where totalassets < 10;	ccks_macro	我们总资产不足1千万的记录有哪些，主要列出时间、外汇金额、货币黄金和其他国外货币的记录 谢谢
select wholesaleretailtrade, foodbeverage from ed_retailvalueofscgoods  where province='上海' and reportperiod ='年度' and strftime('%Y', enddate)='2004';	ccks_macro	嗨，帮我查一下2004年，上海市的批发零售贸易业和餐饮业的社会销售品零售金额的"年度"统计值 谢谢啊
select a.firstindustryname, count(*) from lc_exgindustry as a join lc_sharestru as b on a.companycode = b.companycode where b.nonrestrictedshares  > 10000000000 group by a.firstindustryname	ccks_stock	无限售条件流通A股股数超过100亿的公司有多少家，按公司所在一级行业分组
select a.city , count(*)  from lc_stockarchives as a join lc_coconcept as b on a.companycode = b.companycode where b.conceptname ='大数据' group by a.city ;	ccks_stock	我们来计算一下，各个城市的上市公司中，属于"大数据"这个板块的数量有多少 谢谢
select state from lc_stockarchives  where strftime('%Y', establishmentdate)='2000' group by  state order by count(*) desc limit 1;	ccks_stock	哪个省2000年成立的上市公司最多
select a.industryname, count(*) from lc_business as a join lc_stockarchives as b on a.companycode = b.companycode where b.state = '江苏省' group by a.industryname ;	ccks_stock	简单算一下"江苏省"各行业的上市公司数量
select secuabbr from mf_bondportifoliodetail where bondcode='200203' order by holdvolume limit 1;	ccks_fund	找持有200203最少的基金
select chinameabbr from lc_stockarchives where state='山东省';	ccks_stock	列出山东省的上市公司
select chiname from lc_shnumber  where strftime('%Y', enddate)='2016' order by  shnum desc limit 1;	ccks_stock	2016年股东总户数最多的上市公司
select rrinselectedmonth, rrinsinglemonth from mf_netvalueperformancehis where secuabbr = '天弘恒享';	ccks_fund	同学你好！基金产品名称为天弘恒享的本月以来及一个月回报率
select reportperiod,  indexvalue from ed_producerpiformp where  indextype ='国民经济行业指数' and indexname ='金属制品业';	ccks_macro	我想了解一下数据情况。在咱们表里，关于"国民经济行业指数"中"金属制品业"的记录有哪些，请列出相关统计周期和指标值
select industrialvalueadded from ed_industryproduction  where province ='上海' and statstandard ='全部工业企业' and reportperiod ='年度' and strftime('%Y', enddate)='2000';	ccks_macro	2000年的时候，上海的"全部工业企业"中，"年度"工业增加值是多少
select count(*) from lc_buyback  where buybackmoney >= 100000000 and strftime('%Y', advancedate) = strftime('%Y', DATE('now', '-1 year'));	ccks_stock	我朋友想知道去年单次回购股份总金额达到1亿元的公司数量
select count(*) from lc_sharetransfer where pctbeforetran > 0.2	ccks_stock	siri, 统计一下出让前持股比例超过0.2的公司有多少家
select b.chinameabbr, b.controllername from lc_stockarchives as a join lc_actualcontroller as b on a.companycode = b.companycode where a.city = '杭州市';	ccks_stock	杭州市上市公司的实控人信息
select rrinsixmonth from  mf_netvalueperformancehis ;	ccks_fund	展示一下各基金的六个月回报率
select paidincapital from ed_otherdepositorycorpbs ;	ccks_macro	我们实收资本金额在其他存款性公司资产负债表里，有多少，请列出来 感谢
select chinameabbr from lc_sharesfloatingschedule where proportion2 > 50	ccks_stock	查出已流通A股占A股总数比例超过50%有哪些？
select bondabbr from mf_bondportifoliodetail where secuabbr='中银中国A';	ccks_fund	你好，列出中银中国A持仓的所有债券
select a.chinameabbr from lc_sharesfloatingschedule as a join lc_exgindustry as b on a.companycode = b.companycode where b.firstindustryname = '制造业' order by a.proportion1 desc limit 1	ccks_stock	您好，制造业本次新增可售A股占上期末已流通A股比例最大的公司名称
select count(*) from mf_awards ;	ccks_fund	能统计一下公募基金的评奖机构个数吗 感谢
select chinameabbr, issuepurpose from lc_ashareseasonednewissue  where strftime('%Y', advancedate)='2021';	ccks_stock	2021年有哪些公司发生过股票增发，它们的增发目的是什么
select gdp from ed_grossdomesticproduct ;	ccks_macro	展示一下我国的国内生产总值
select count(*) from mf_fmscaleanalysisn where totalfundnv > 500;	ccks_fund	帮我找找数据，计算出有几个基金经理的管理总规模超过500亿
select count(*) from lc_legaldistribution  where strftime('%Y', infopubldate) = strftime('%Y', DATE('now', '-1 year'));	ccks_stock	我想了解一下数据情况。前一年有配售股票记录的公司有几家
select fund from mf_awards where awardname = '中国股票型对冲基金奖提名' and appraisalorg ='晨星资讯';	ccks_fund	同学你好！帮我查下"晨星资讯"这家机构的"中国股票型对冲基金奖提名"颁发给了哪些基金，请列出基金名称
select csrcindustryname from lc_ipodeclaration where chinameabbr='红塔证券'; 	ccks_stock	你好，红塔证券ipo信息中所属行业是什么
select b.type, count(*) from mf_fundreturnrank as a join mf_fundarchives as b on a.innercode = b.innercode where a.indexcycle = '一年' and a.fundreturn < 0 group by b.type	ccks_fund	显示指标周期为"一年"的基金收益率为负的基金数目，按基金运作方式分组展示 感谢
select enddate, retailvalueofscgoods from ed_retailvalueofscgoods  where reportarea ='全国' and reportperiod ='年度' and strftime('%Y', enddate) > strftime('%Y', DATE('now', '-3 year')) ;	ccks_macro	展示一下最近三年，全国的"年度"社会消费品零售总金额，用时间区分
select a.conceptname, count(*) from lc_coconcept as a join lc_stockarchives as b on a.companycode = b.companycode where b.state ='广东省' group by a.conceptname having count(*)>4  ;	ccks_stock	"广东省"上市公司数量超过4的板块名称是那些，并列出具体个数
select bondabbr from mf_bondportifoliodetail where secucode='160611';	ccks_fund	检索一下160611的持有债券名称
select investstyle,count(*) from mf_fundarchives group by investstyle;	ccks_fund	统计一下各种投资风格的基金的数量
select shname, holdingpct from lc_relatedsh  where chinameabbr = '农发种业' and strftime('%Y', enddate)='2019' ;	ccks_stock	嘿，列出2019年以来，农发种业的股东名称和持股比例
select  secucode from lc_relatedsh  where shname ='万安集团有限公司' and strftime('%Y', enddate) = strftime('%Y', DATE('now', '-1 year'));	ccks_stock	"万安集团有限公司"去年买了那几家公司的股份
select b.secuabbr,b.investadvisorname from mf_bondportifoliodetail as a join mf_fundarchives as b on a.innercode=b.innercode where a.bondabbr='21国债06' order by a.ratioinnv desc limit 1;	ccks_fund	找出持仓21国债06占净资产比例最高的基金及基金管理人
select investadvisorabbrname from mf_investadvisoroutline order by regcapital desc limit 3;	ccks_fund	注册资本排行前3的基金管理人是哪些
select a.state , count(*)  from lc_stockarchives as a join lc_coconcept as b on a.companycode = b.companycode where b.conceptname ='芯片概念' group by a.state having count(*)>5;	ccks_stock	hello,评价一下"芯片概念"板块，上市公司超过5的省份有哪些，列出省份名称和具体数量
select count(*) from lc_business where industryname like '%计算机%' or industryname like '%通信%'	ccks_stock	通信行业和计算机行业的上市公司有多少
select b.investmenttype,count(*) from mf_benchmarkgrowthrate as a join mf_fundarchives as b on a.innercode=b.innercode where a.benchgrforthisyear<0 group by b.investmenttype;	ccks_fund	给出各基金投资类型中基金今年以来基金基准增长率为负的个数
select count(*) from mf_fmretscaleanalysis as a join mf_personalinfo as b on a.personalcode = b.personalcode where a.totalaum > 100 and b.education = '本科'	ccks_fund	基金经理学历为"本科"且所管理的基金总规模超过100亿元的基金经理人数
select avg(b.totalfundnv) from mf_personalinfo as a join mf_fmscaleanalysisn as b on a.personalcode = b.personalcode where a.experiencetime > 15;	ccks_fund	统计出证券从业经验大于15年的基金经理管理基金规模平均值
select enddate, province, industrialoutputvalueap from ed_industryproduction where reportarea ='省市' and statstandard ='全部工业企业' and reportperiod ='期末累计'  ;	ccks_macro	帮我看看各"省市"的"全部工业企业"，每年的"期末累计"工业总产值是多少 谢谢啊
select maxchargerate, minchargerate from mf_chargeratenew where secuabbr ='南方天元';	ccks_fund	找一下数据。我持有"南方天元"一点时间了，我当时买的少，帮我看一下它的费率最高值和最低值
select b.type, count(*) from mf_fundreturnrank as a join mf_fundarchives as b on a.innercode = b.innercode where a.indexcycle = '一个月' and a.fundreturn > 0 group by b.type	ccks_fund	显示指标周期为"一个月"的基金收益率为正的基金数目，按基金运作方式分组展示
select a.distributionsum from lc_legaldistribution as a  where strftime('%Y', a.infopubldate)='2020' and strftime('%m', a.infopubldate)='3' and a.chinameabbr ='国网英大'	ccks_stock	统计下2020年3月国网英大配售总股数有多少
select thirdindustrygdp from ed_grossdomesticproduct ;	ccks_macro	列出历年我国第三产业国内生产总值的数据大小
select expensedrdinput,capitalizedrdinput from lc_intassetsdetail  where strftime('%Y', enddate)=strftime('%Y', DATE('now', '-1 year')) and chinameabbr='深科技';	ccks_stock	去年深科技的费用化研发投入、资本化研发投入分别是多少
select count(*) from lc_executivesholdings where  chinameabbr = '拓维信息' and positiondescription like '%董事%'	ccks_stock	您好，拓维信息有多少个董事？
select a.name, a.secuabbr from mf_fundmanagernew as a join mf_personalinfo as b on a.personalcode = b.personalcode where b.education = '本科'	ccks_fund	查一下学历为本科的基金经理管理过哪些基金？
select count(*) from lc_sharesfloatingschedule where accumarketableashares > 1000	ccks_stock	已流通A股股数超过1000万股的公司有多少家 谢谢
select a.issueobject, b.generalmanager, b.legalrepr from lc_ashareseasonednewissue as a join lc_stockarchives as b on a.companycode = b.companycode where a.chinameabbr = '晶盛机电';	ccks_stock	siri, 晶盛机电增发股票面向哪些投资者, 该公司的总经理，法人分别是谁？
select b.chinesename,b.birthdate from mf_fmscaleanalysisn as a join mf_personalinfo as b on a.personalcode=b.personalcode where a.bondfundn>3;	ccks_fund	找找哪些基金经理管理的债券型基金数量超过3个及出生日期信息 谢谢
select count(*) from lc_mainoperincome  where mainoperincome > 100000000 and strftime('%Y', enddate)>='2019';	ccks_stock	算一下2019年来，有几家公司的主营业务利润大于1亿元
select risklevel from mf_fundrisklevel where secuabbr = '国金50'	ccks_fund	国金50的风险等级是什么？
select chinameabbr from lc_actualcontroller where controllername = '中国烟草总公司';	ccks_stock	哪些公司的实际控制人是中国烟草总公司
select leadername from lc_executivesholdings where chinameabbr = '恒宝股份' and positiondescription like '%副总裁%'	ccks_stock	恒宝股份的副总裁有哪几位？
select a.industryname , count(*) from lc_business as a join lc_stockarchives as b on a.companycode = b.companycode  where strftime('%Y', b.establishmentdate)='2020' group by  a.industryname ;	ccks_stock	帮我看看2020年成立的各行业上市公司分别有多少家 谢谢
select chinameabbr from lc_freefloat order by afloats desc limit 5	ccks_stock	A股流通股本最多的5家公司是什么？
select secuabbr, secucode  from mf_mainfinancialindexq  where strftime('%Y', enddate)='2021' group by  secuabbr order by sum(totalprofit) desc limit 10	ccks_fund	2021年基金赚钱榜前十的基金及其基金代码
select csrcindustryname from lc_ipodeclaration group by csrcindustryname order by count(*) limit 10;	ccks_stock	找下哪十个行业ipo的公司最少
select a.state from lc_stockarchives as a join lc_sharestru as b on a.companycode = b.companycode where b.nonlistedshares > 200000000 group by a.state having count(*) > 10	ccks_stock	请告诉我，哪个省份的未流通A股股数超过2亿的公司数目超过10家 谢谢啊
select b.city, count(*) from lc_sharesfloatingschedule as a join lc_stockarchives as b on a.companycode = b.companycode where a.newmarketableashares > 100 group by b.city	ccks_stock	本次新增可售A股股数超过100万股的公司有多少家，按城市分组展示
select secuabbr from mf_benchmarkgrowthrate where benchgrforthisweek<0 order by benchgrforthisweek limit 10;	ccks_fund	本周以来基金基准增长率为负的基金由低到高的排名
select a.name from mf_fundmanagernew as a join mf_fundrisklevel as b on a.innercode = b.innercode where b.risklevel = '中低' group by a.name having count(a.secuabbr) > 5 	ccks_fund	找到持有基金风险等级为"中低"的基金数目超过5只的基金经理名称
select rrinsingleweek from  mf_netvalueperformancehis ;	ccks_fund	能帮我看看各基金的一周回报率信息吗
select gyoyofimvaluegoods, gyoyofexvaluegoods from ed_exportimport ;	ccks_macro	王工想知道我们历年的进口同比增减数据和出口同比增减数据，麻烦提供下
select securitiescorpsholdpropa from lc_stockholdingst  where strftime('%Y', enddate)='2020' and strftime('%m', enddate)='2' and chinameabbr='重庆建工';	ccks_stock	2020年2月券商持有的重庆建工非限售流通股比例
select enddate, unitnv from  mf_netvalue  where strftime('%Y', enddate) > strftime('%Y', DATE('now', '-2 year')) and secuabbr ='华安石油A' ;	ccks_fund	哥，最近两年，"华安石油A"的每日单位净值是多少，
select chinameabbr from lc_freefloat where totalashare > 1000000000 order by adjfreefloatratio desc	ccks_stock	A股总股本超过10亿的公司有哪些，按自由流通比例从大到小排序
select avg(numberoffunds) from mf_fmscaleanalysisn;	ccks_fund	帮我找一下数据！全市场每个基金经理平均管理了多少只基金
select a.state from lc_stockarchives as a join lc_exgindustry as b on a.companycode = b.companycode where b.firstindustryname = '批发和零售业' group by a.state having count(*) > 3	ccks_stock	哪些省份的公司的一级行业为"批发和零售业"数量超过3家？
select chinameabbr from lc_stockarchives where secretarybd='冯莉';	ccks_stock	给我找下冯莉是哪个上市公司的董秘
select accumarketableashares, nonmarketableashares from lc_sharesfloatingschedule where chinameabbr = '通富微电' or chinameabbr = '海亮股份'	ccks_stock	请问通富微电和海亮股份的已流通A股股数和待流通A股股数分别是多少？ 谢谢啊
select issuepurpose from lc_ashareseasonednewissue where chinameabbr = '京能置业';	ccks_stock	哥，京能置业股票增发的目的是啥
select a.secuabbr,a.dailybenchgr from mf_benchmarkgrowthrate as a join mf_fundarchives as b on a.innercode=b.innercode   where b.fundtype='股票型';	ccks_fund	查询股票型基金和它们的本日基金基准增长率情况
select experiencetime from mf_personalinfo where chinesename = '蒋一茜';	ccks_fund	找一下蒋一茜的基金从业年限 谢谢啊
select gdp, gdppercapita from ed_grossdomesticproduct ;	ccks_macro	这是我能知道的吗，咱们每年的国内生产总值数据和人均国内生产总值数据
select bondabbr,marketvalue,ratioinnv from mf_bondportifoliodetail where secucode='159901';	ccks_fund	159901持仓了债券吗，市值和比例都是多少？
select grossprofit from lc_mainoperincome  where strftime('%Y', enddate) = strftime('%Y', DATE('now', '-1 year')) and chinameabbr ='冰山冷热';	ccks_stock	我朋友持有冰山冷热的股票，他家去年的毛利率是多少
select b.education, count(*) from mf_managerexperience a join mf_personalinfo b on a.personalcode = b.personalcode where a.investadvisorname like '富国基金%' and a.incumbent = '是'  group by b.education	ccks_fund	富国基金现任基金经理学历分布
select rrinsingleyear from mf_netvalueperformancehis ;	ccks_fund	查询一下各基金的一年回报率值
select rrinselectedweek, rrinsingleweek from mf_netvalueperformancehis where secuabbr = '银华纯债';	ccks_fund	哥，你好，我想查基金产品银华纯债的本周以来和一周回报率数据
select count(*) from mf_benchmarkgrowthrate as a join mf_fundarchives as b on a.innercode=b.innercode where a.benchgrforthismonth>3 and b.type='ETF';	ccks_fund	ETF基金本月以来基金基准增长率超过3%有多少 谢谢啊
select fullname,underwritingsum from lc_issueandlistagent where chinameabbr='南华生物';	ccks_stock	列出南华生物股票上市时参与的机构名称及承销金额
select enddate, subjectsum from ed_newincreasingloan;	ccks_macro	咱们金融机构新增贷款每年的新增金额是多少啊
select bonusshareratio, cashdivirmb from lc_dividend  where secucode ='000752' and strftime('%Y', dividendimplementdate) = strftime('%Y', DATE('now', '-1 year')) ;	ccks_stock	帮我找找数据，我持有000752，它去年的送股比例和派现金额是多少
select fpshname, pctofpledger from lc_sharefp  where strftime('%Y', enddate) = strftime('%Y', DATE('now', '-1 year'));	ccks_stock	我想知道去年有哪些股东有股份被冻结质押的记录，列出这些记录，包含投资者名称和占冻结质押方持股数量的比例
select dailybenchgr from mf_benchmarkgrowthrate where secucode='512500';	ccks_fund	512500的本日基金基准增长率是多少 感谢
select rrsincestart, annualizedrrsincestart from mf_netvalueperformancehis ;	ccks_fund	展示一下基金设立以来回报率和设立以来年化回报率的数据
select rrsincethisyear from mf_netvalueperformancehis ;	ccks_fund	同学你好！查询一下各基金今年以来回报率数据
select chinameabbr from lc_ashareseasonednewissue order by plannedproceeds desc limit 1;	ccks_stock	单次股票增发预计募集资金总额最大对应的上市公司是哪个
select b.chinameabbr from lc_issueandlistagent as a join lc_stockarchives as b on a.companycode=b.companycode  where b.state='辽宁省' and a.underwritingvol>1000000 and a.underwritingsum>10000000;	ccks_stock	辽宁省上市公司中股票发行承销数量大于1百万股且承销金额大于1千万元的有哪些 感谢
select leadername from lc_executivesholdings  where chinameabbr = '科拓生物' and strftime('%Y', enddate)='2020'	ccks_stock	2020年科拓生物在职的高管有哪些？ 谢谢啊
select aquirername from lc_legaldistribution  where secucode = '603059' and strftime('%Y', infopubldate) = strftime('%Y', DATE('now', '-1 year')) and strftime('%m', infopubldate)='4' order by  aquireramount desc limit 10 ;	ccks_stock	603059在去年四月的股份配售中，获配金额前10的投资者是哪些 感谢
select a.conceptname, count(*) from lc_coconcept as a join lc_stockarchives as b on a.companycode = b.companycode where b.city ='南京市' group by a.conceptname ;	ccks_stock	请统计一下"南京市"个板块的上市公司数量，列出板块名称和数量 感谢
select expenditurecitymc, operatingexpensescesh from ed_financialbalance where province ='四川';	ccks_macro	又到了审计期间了，列出四川省历年的城市维护建设费和地方财政支出
select enddate, imvalueofgoods , exvalueofgoods from ed_exportimport  where gyoyofexvaluegoods > 0 and exvalueofgoods > 40 and strftime('%Y', enddate) > strftime('%Y', DATE('now', '-10 year'));	ccks_macro	给王工提供一下，这十年来，我国出口金额达到4000万，并且出口同比增长的记录，包含时间、进口金额和出口金额
select province from ed_grossdomesticproduct  where strftime('%Y', enddate) = strftime('%Y', DATE('now', '-1 year')) order by  primaryindustrygdp desc limit 10;	ccks_macro	能帮我列出去年第一产业生产总值排名前十的省市名单吗
select shname from lc_relatedsh  where holdingsum > 10000000 and secucode ='600110' and strftime('%Y', enddate) = strftime('%Y', DATE('now', '-1 year'));	ccks_stock	去年，600110这支股票的投资者中，哪些投资者的投资数量达到千万级 谢谢
select secucode, holdingsum, shinvestsum from lc_relatedsh where shname ='顾瑜';	ccks_stock	我想知道"顾瑜"买了哪些公司的股票，持股数量和金额分别是多少
select annualizedrrinthreeyear from mf_netvalueperformancehis ;	ccks_fund	查询基金的三年年化回报率大小
select secuabbr from mf_bondportifoliodetail where bondabbr='20国债10';	ccks_fund	哪些基金持有20国债10
select secuabbr from mf_fundarchives  where investadvisorname='易方达基金管理有限公司' and fundtype='股票型' and strftime('%Y', establishmentdate)='2021';	ccks_fund	有哪些股票型基金是易方达基金管理有限公司2021年设立的？ 感谢
select enddate, totalliability from ed_moneyauthoritybs  order by totalliability  desc ;	ccks_macro	能帮我看一下我们的历史数据中，每年的总负债书据详情吗，按照总负债金额降序排列
select secuabbr, investadvisorname from mf_fundarchives order by establishmentdate asc limit 1	ccks_fund	哪只基金设立时间最早，它的管理人是谁
select cashdivirmb, actualcashdivirmb from lc_dividend  where chinameabbr ='古井贡酒' and strftime('%Y', dividendimplementdate) = strftime('%Y', DATE('now', '-1 year')) ;	ccks_stock	展示一下数据，查一下去年古井贡酒派现金额和实派人民币金额
select a.city, count(*) from lc_stockarchives as a join lc_sharestru as b on a.companycode = b.companycode where b.nonrestrictedshares > 10000000000 group by a.city	ccks_stock	无限售条件流通A股股数超过100亿的公司有多少家，按公司所在城市分组
select annualizedrrinthreeyear from mf_netvalueperformancehis ;	ccks_fund	请列出基金的三年年化回报率大小
select a.actualshares,a.oughtshares from lc_largeshsubscription as a join lc_stockarchives as b on a.companycode=b.companycode  where b.state='广西省';	ccks_stock	广西省上市公司及它们配股时的应配股数与实际配股数
select financialbonds, sharesandotherinvestments from ed_chinafibalancesheetrmb; 	ccks_macro	快速找一下数据。能给我查一下我国金融机构信贷收支中，金融债券和有价证券及投资金额吗
select gdp, gdppercapita from ed_grossdomesticproduct where province ='山东' ;	ccks_macro	请帮我看一下山东省每年的gdp和人均gdp数据
select b.chinameabbr from lc_intassetsdetail as a join lc_stockarchives as b on a.companycode=b.companycode  where b.state='广东省' order by a.rdstaffnumratio desc, a.rdinputratio desc limit 10;	ccks_stock	广东省研发人员比例最高的公司中研发投入占比最高的十个公司
select interestexpense from lc_financialexpense  where chinameabbr = '再升科技' or chinameabbr = '蓝思科技' and strftime('%Y', enddate)='2017'	ccks_stock	帮我查一下，2017年再升科技和蓝思科技的利息支出
select bondabbr from mf_bondportifoliodetail where secuabbr='易方达中盘ETF' order by ratioinnv desc limit 1;	ccks_fund	易方达中盘ETF持有的债券中占其资产净值最高的是哪个
select a.state , count(*)  from lc_stockarchives as a join lc_coconcept as b on a.companycode = b.companycode where b.conceptname ='大飞机' group by a.state ;	ccks_stock	统计一下"大飞机"板块，各省市的上市公司数量分别是多少 谢谢
select rrinthreemonth from mf_netvalueperformancehis where secuabbr = '诺德债券';	ccks_fund	帮我找一下数据！评价一下诺德债券的三个月回报率表现
select establishmentdate from lc_stockarchives where chinameabbr='华昌达';	ccks_stock	华昌达的成立日期 谢谢
select secucode , shinvestsum from lc_relatedsh  where shname ='万安集团有限公司' and strftime('%Y', enddate) = strftime('%Y', DATE('now', '-2 year'));	ccks_stock	"万安集团有限公司"前年买了那些公司的股份，投资金额分别是多少
select chinameabbr from lc_ashareseasonednewissue  where strftime('%Y', advancedate)='2022';	ccks_stock	我想了解一下数据情况。2022年有哪些公司开展过股票增发
select totalshares, ashares from lc_sharestru where secucode = '600371'	ccks_stock	列出600371的总股本和A股股本信息
select enddate, livalueap from ed_industryproduction where reportarea ='全国' and statstandard ='国有及规模以上工业企业' and reportperiod ='期末累计';	ccks_macro	这些年来，我们"全国"范围内，"国有及规模以上工业企业"中，轻工业的"期末累计"工业生产总值是多少哇
select count(a.name) from mf_fundmanagernew as a join mf_personalinfo as b on a.personalcode = b.personalcode where b.education = '博士' and b.gender = '男'	ccks_fund	学历为博士且性别为男的基金经理有多少位？
select advancedate, issuepurpose, issueobject from lc_ashareseasonednewissue where chinameabbr = '大业股份';	ccks_stock	大业股份什么时候进行增发了？增发目的和对象分别是什么
select secuabbr from mf_fundreturnrank where fundtypename = '股票型' and fundannreturn > 0	ccks_fund	筛选基金类别描述为"股票型"，且基金年化收益率大于0的基金名称
select signatureaccountant,signaturelaw from lc_ipodeclaration where chinameabbr='华纳百录'; 	ccks_stock	华纳百录ipo的签字会计师和签字律师分别是谁
select chinameabbr , buybackmoney from lc_buyback  where (chinameabbr = '会稽山' or chinameabbr = '宝钢股份') and strftime('%Y', advancedate)='2020' ;	ccks_stock	2020年宝钢股份和会稽山的股份回购情况分别是什么，列出股票名称和股份回购总金额
select chinameabbr from lc_financialexpense order by exchangeproloss desc limit 20	ccks_stock	嘿，汇兑损益排名前20的公司有哪些？
select fundtypename from mf_fcretscalerank where abbrchiname='中信证券' order by totalaumrank desc limit 1;	ccks_fund	哥，中信证券哪个类型的基金的总管理规模同类排名最低
select b.secuabbr,b.manager from mf_bondportifoliodetail as a join mf_fundarchives as b on a.innercode=b.innercode where a.bondabbr='百润转债' order by a.marketvalue desc limit 1;	ccks_fund	哪个基金持仓百润转债的市值最高，基金经理是谁？
select count(*) from lc_legaldistribution  where aquiredsum < 10000 and strftime('%Y', infopubldate) = strftime('%Y', DATE('now', '-1 year'));	ccks_stock	方便统计下前一年配售股份不足1万份的投资者数量吗
select secuabbr from mf_benchmarkgrowthrate where benchgrfor7year>200;	ccks_fund	看看七年基金基准增长率超过200%的基金有哪些
select stdivstand1, endivstand1 from mf_chargeratenew where chargeratetydes ='指数许可费';	ccks_fund	"指数许可费"的费率划分标准范围的起始数值和截止数值一般是多少
select stockabbr, count(*) from mf_keystockportfolio where stockabbr = '宁德时代' or stockabbr = '贵州茅台' group by stockabbr	ccks_fund	有几只基金看好贵州茅台，有几只基金看好宁德时代
select b.secuabbr, b.risklevel from mf_fundmanagernew as a join mf_fundrisklevel as b on a.innercode = b.innercode where a.managementtime > 1000	ccks_fund	你好，找到任职天数超过1000天的基金经理所管理的基金名称和基金风险等级
select jointventures, selfemployed from ed_retailvalueofscgoods where province ='浙江' and reportperiod ='年度';	ccks_macro	能展示一下浙江省合营单位和个体单位历年"年度"社会消费品零售数据吗
select b.secuabbr,b.fundtype,b.manager from mf_benchmarkgrowthrate as a join mf_fundarchives as b on a.innercode=b.innercode where a.benchgrfor10year>50;	ccks_fund	有哪些基金的十年基金基准增长率超过50%，类型和经理的信息也给下
select chiname from lc_sharefp  where strftime('%Y', enddate)='2018' and strftime('%m', enddate)='5' order by  involvedsum desc limit 10	ccks_stock	您好，2018年5月被冻结质押股数前10的公司是哪几家
select count(*) from mf_bondportifoliodetail where secuabbr='华夏50ETF';	ccks_fund	查下华夏50ETF持有多少债券产品
select  fpshname from lc_sharefp  where strftime('%Y', enddate) > strftime('%Y', DATE('now', '-3 year'));	ccks_stock	最近三年，有哪些投资者的股份被冻结质押过，查询一下投资者名称
select count(*) from mf_fundmanagernew where incumbent = '在任' and postname = '基金经理助理'	ccks_fund	同学你好！查一下，有多少位在任的基金经理助理
select b.chinesename, b.totalfundnv, b.equityfundnv, b.hybridfundnv from mf_personalinfo as a join mf_fmscaleanalysisn as b on a.personalcode = b.personalcode where a.nationality != '中国';	ccks_fund	您好，非'中国'籍基金经理有哪些？管理基金总规模，股票型基金规模，混合型基金规模分别是多少
select issuepurpose from lc_ashareseasonednewissue where chinameabbr = '京能置业';	ccks_stock	帮我查一下京能置业进行股票增发的目的
select b.fundtype from mf_netvalueperformancehis as a join mf_fundarchives as b on a.innercode = b.innercode group by b.fundtype having avg(a.rrinsingleyear) > 1;	ccks_fund	哪些基金类型对应的基金产品一个月回报均值大于1
select secucode, floatshare from qt_monthdata where secucode = '600168' or secucode = '000422';	ccks_stock	对比600168，000422两只股票的月频流通股本变化情况
select website from lc_stockarchives where chinameabbr='万科';	ccks_stock	万科的网站地址
select fundmanager , awardname from mf_awards where appraisalorg = '证券时报';	ccks_fund	还有啊，"证券时报"给哪些基金经理都颁发了什么奖项
select b.manager,b.investadvisorname from mf_fmscaleanalysisn as a join mf_fundarchives as b on a.chinesename=b.manager order by a.numberoffunds desc limit 1;	ccks_fund	帮我查一下这些数据。找出那个基金经理旗下基金总数做多，及基金管理人是谁
select buybackprice, buybacksum from lc_buyback  where chinameabbr = '南都电源' and strftime('%Y', advancedate)='2021'	ccks_stock	您好，我想知道南都电源2021年有没有回购操作，列出回购价格和回购总数量
select totalshare, pb, pettm from qt_monthdata where secucode = '000935';	ccks_stock	帮我查一下这些数据。展示000935每个月的总股本，PB和PE信息
select a.chinesename, b.background from mf_fmretscaleanalysis as a join mf_personalinfo as b on a.personalcode = b.personalcode where a.weightedavgreturn > 0 and a.timeinterval = '近10年'	ccks_fund	时间区间为"近10年"，基金收益率大于0的基金经理姓名和背景介绍
select fund from mf_awards where strftime('%Y', `year`) >=2015 and awardname ='投资基金';	ccks_fund	你知道2015年至今，获奖对象为“投资基金”中获得过奖项的基金名称有哪些吗
select  clienttype from mf_chargeratenew where secucode ='160133';	ccks_fund	我朋友想买160133，他是一般投资者，查一下160133的投资者类型
select exvalueofgoods, gyoyofexvaluegoods from ed_exportimport  where strftime('%Y', enddate) = strftime('%Y', DATE('now', '-1 year')) ;	ccks_macro	帮我找找数据，嘿，帮忙看看我国去年的商品出口金额和商品出口同比增减金额分别是多少
select chinameabbr from lc_sharestru where restrictasharep > 100000000	ccks_stock	有限售流通A股股本超过1亿的公司有哪些？
select secucode from mf_benchmarkgrowthrate where benchgrfor5year>50;	ccks_fund	帮我查一下这些数据。五年基金基准增长率超过了50%的基金代码
select gdppercapita from ed_grossdomesticproduct ;	ccks_macro	嘿，咱们这些年的人均国内生产总值是多少啊
select fpshname, involvedsum from lc_sharefp where chinameabbr = '瑞茂通';	ccks_stock	瑞茂通的股权冻结情况是怎么样的，列出股权被冻结质押股东名称和涉及股数
select chinesename,hybridfundnv from mf_fmscaleanalysisn order by hybridfundnv desc limit 10;	ccks_fund	混合型管理规模排名前十的经理及具体规模
select enddate,  depositswithcentralbank , cashinvault from ed_otherdepositorycorpbs  where strftime('%Y', enddate)>='2008';	ccks_macro	2008年至今，我们每年的准备金存款金额和库存现金是多少啊，在其他存款性公司资产负债数据表中
select chinameabbr from lc_stockarchives where state='湖北省' and city='武汉市';	ccks_stock	hello,湖北省武汉市有哪些企业
select a.chinameabbr from lc_stockarchives as a join lc_exgindustry as b on a.companycode = b.companycode where a.state = '浙江省' and b.firstindustryname = '科学研究和技术服务业'	ccks_stock	列出浙江省一级行业为"科学研究和技术服务业"的公司名
select avgholdsumgrhalfayear from lc_shnumber  where strftime('%Y', enddate)='2020' and chinameabbr='京基智农';	ccks_stock	京基智农2020年户均持股数半年增长率
select wholesaleretailtrade from ed_retailvalueofscgoods ;	ccks_macro	我想了解一下数据情况。能帮我查一下我们批发零售贸易业金额大小吗
select businessmajor from lc_business lb where chinameabbr ='天齐锂业'	ccks_stock	帮我确认一下天齐锂业的主要经营范围
select legalrepr from lc_stockarchives where chinameabbr='药明康德';	ccks_stock	药明康德的法人代表
select chargeratetydes , divstand1  from mf_chargeratenew where secuabbr ='汇添富经典';	ccks_fund	你知道"汇添富经典"的费率类型和费率划分标准吗
select chinameabbr, controllername from lc_actualcontroller where secucode like '00%';	ccks_stock	查出全部00开头的上市公司简称及相应实控人
select count(*) from lc_sharefp where involvedsum > 10000000;	ccks_stock	siri, 展示下有多少股票的冻结质押数量超过了1千万
select secuabbr from mf_benchmarkgrowthrate order by benchgrfor3year desc limit 1;	ccks_fund	哪个基金的三年基金基准增长率最高
select secuabbr from mf_benchmarkgrowthrate where benchgrfor3year>0;	ccks_fund	找下三年基金基准增长率为正的基金
select secuabbr,annualizedbrforsince from mf_benchmarkgrowthrate order by annualizedbrforsince desc limit 10;	ccks_fund	基金成立以来基准年化增长率最高的十支基金排名及具体数值是多少 谢谢
select rrinfiveyear from mf_netvalueperformancehis ;	ccks_fund	帮李老师看看我们的库里，基金的五年回报率记录哦
select secucode, chinameabbr from lc_coconcept where conceptname like '%新能源%';	ccks_stock	最近可以布局新能源产业了，帮我查一下新能源板块有什么股票
select chinameabbr from lc_financialexpense order by commission desc limit 5	ccks_stock	手续费排名前5的公司有哪些？ 谢谢
select chinameabbr,astockcode from lc_stockarchives where state='新疆维吾尔自治区';	ccks_stock	帮我找找数据，新疆的上市公司和它们的代码都是多少
select rrinsingleyear , rrinthreeyear, rrinfiveyear from mf_netvalueperformancehis ;	ccks_fund	李工想买基金，给他展示一下基金的一年收益率、三年收益率、五年收益率
select count(*) from mf_fundarchives  where secumarket='上海证券交易所' and type='LOF' and strftime('%Y', listeddate)='2021';	ccks_fund	帮我查一下这些数据。2021年在上海证券交易所上市了多少LOF基金？
select chinesename from mf_personalinfo  where strftime('%Y', practicedate) = strftime('%Y', date())	ccks_fund	今年刚开始从事证券行业的基金经理有哪些
select a.state from lc_stockarchives as a join lc_sharestru as b on a.companycode = b.companycode where b.nonrestrictedshares > 10000000000 group by a.state having count(*) > 10	ccks_stock	帮我查一下，哪个省份的无限售条件流通A股股数超过100亿的公司数目超过10家
select totalprofitpershare from mf_mainfinancialindexq  where secuabbr = '招商成长' and strftime('%Y', enddate)='2021' and round(strftime('%m',enddate)/3.0 + 0.495) = 3	ccks_fund	2021年第3季度招商成长的加权平均基金份额利润 谢谢
select * from mf_netvalueperformancehis where rrinsingleyear > 50 and rrintwoyear > 50;	ccks_fund	找到一年、两年回报率都超过50的基金产品，并展示所有维度数据
select count(*)  from lc_coconcept as a join lc_stockarchives as b on a.companycode = b.companycode where a.conceptname ='电商概念' and b.city ='杭州市';	ccks_stock	同学你好！请帮忙统计一下，"杭州市"的上市公司中，"电商概念"这个板块有多少数量
select a.secucode , b.officeaddr from lc_business as a join lc_stockarchives as b on a.companycode = b.companycode where a.industryname ='零售业';	ccks_stock	小王哦，方便帮我获取一下"零售业"这个行业的上市公司代码和公司的联系地址吗
select secucode from lc_coconcept where conceptname like '%百度概念%' and conceptname like '%阿里概念%';	ccks_stock	百度概念板块和阿里概念板块有没有相同的股票，有的话，列出股票代码
select gdp, gdppercapita from ed_grossdomesticproduct  where province ='山东' and  strftime('%Y', enddate) > strftime('%Y', DATE('now', '-5 year') ) ;	ccks_macro	hello,嗨，帮我看看山东省这五年来的国内生产总值和人均国内生产总值金额
select education from mf_personalinfo group by education having avg(experiencetime) > 10;	ccks_fund	哪些学历水平对应基金经理从业年限平均值大于10
select depositsincludedinm2 from ed_otherdepositorycorpbs ;	ccks_macro	在其他存款性公司资产负债表中，纳入广义货币的存款金额有多少呢 谢谢啊
select count(*) from mf_fmscaleanalysisn where qdiinv > 200;	ccks_fund	在线等，有几位基金经理管理的qdii类型基金总规超过200亿
select count(*) from lc_business as a join lc_business as b on  a.industryname = b.industryname where b.chinameabbr = '深科技'	ccks_stock	展示一下数据，统计和深科技同行业的企业数量
select count(*) from lc_ashareseasonednewissue  where strftime('%Y', advancedate)='2022';	ccks_stock	计算出2022年至今有几家公司增发股票了
select shareamountbeginning, shareamount from lc_executivesholdings where chinameabbr = '顺网科技' and positiondescription like '%董事长%'	ccks_stock	siri, 找出顺网科技董事长的期初持股数和期末持股数
select enddate, livalueap from ed_industryproduction where reportarea ='全国' and statstandard ='国有及规模以上工业企业' and reportperiod ='年度';	ccks_macro	请展示一下这些年来，"全国""国有及规模以上工业企业"中，轻工业的"年度"工业生产总值金额
select b.secuabbr,b.manager from mf_bondportifoliodetail as a join mf_fundarchives as b on a.innercode=b.innercode order by a.holdvolume desc limit 10;	ccks_fund	给出持有债券张数最多的前10个基金和它们的基金经理 谢谢啊
select a.secuabbr from mf_fundreturnrank as a join mf_fundarchives as b on a.innercode = b.innercode where b.fundtype = '股票型' order by fundannreturn desc limit 10	ccks_fund	筛选基金类别为"股票型"基金中基金年化收益率排名前10的基金名称
select indexvalue from ed_producerpiformp where reportperiod ='上年同期' and indextype ='工业结构分类指数' and indexname ='生活资料-耐用消费品';	ccks_macro	帮李老师看看"工业结构分类指数"里，"上年同期""生活资料-耐用消费品"的一般指数值
select a.annreturnsd, a.anndsrisk from mf_fmperfanalysis as a join mf_personalinfo as b on a.personalcode = b.personalcode where b.experiencetime < 5	ccks_fund	列出证券从业经历小于5年的基金经理的年化收益标准差和年化下行风险
select count(*) from mf_netvalueperformancehis where rrinsingleyear > 30 and rrintwoyear > 30 and rrinthreeyear > 30;	ccks_fund	嘿，帮我统计一下一年、两年和三年回报率均大于30%的基金产品有多少只
select count(*) from lc_executivesholdings where  secucode = '002104' and  positiondescription like '%副总裁%'	ccks_stock	快速找一下数据。帮我统计一下，002104有多少个副总裁？
select b.secuabbr ,b.manager from mf_benchmarkgrowthrate as a join mf_fundarchives as b on a.innercode=b.innercode  where a.benchgrforthismonth>5;	ccks_fund	筛选一下哪些基金本月以来基金基准增长率大于5%及基金经理是谁
select enddate, retailvalueofscgoods from ed_retailvalueofscgoods  where reportarea ='省市' and reportperiod ='期末累计' and strftime('%Y', enddate) > strftime('%Y', DATE('now', '-3 year')) ;	ccks_macro	查询一下，我国各省市最近三年"期末累计"社会消费品销售总金额，
select gender, count(*) from mf_personalinfo group by gender;	ccks_fund	不同性别基金经理分别有多少
select fundmanager from mf_awards where appraisalorg = '中国基金报社';	ccks_fund	我想查一下有哪些基金经理曾经获得过"中国基金报社"颁发的奖项
select closeprice from qt_dailyquote  where strftime('%Y', tradingday)='2021' and strftime('%m', tradingday)='1' and strftime('%d', tradingday)='21' and secucode = '002153';	ccks_stock	002153这只股票在2021年1月21日的收盘价
select aquirername, aquireramount from lc_legaldistribution  where secucode = '603059' and strftime('%Y', infopubldate)='2020' order by  aquireramount desc ;	ccks_stock	2020年603059的股份配售中，投资者有哪些，列出投资者名称和金额，并按照获配金额的降序排列
select chinameabbr from lc_dividend  where strftime('%Y', dividendimplementdate) > strftime('%Y', DATE('now', '-10 year')) group by  chinameabbr order by count(*) desc limit 1;	ccks_stock	快速找一下数据。我想看看最近10年分红送转次数最多的公司
select pctbeforetran, pctaftertran from lc_sharetransfer  where chinameabbr = '朗新科技' and strftime('%Y', trandate)='2019'	ccks_stock	显示2019年朗新科技的出让前持股比例和出让后持股比例
select b.chinameabbr, a.firstindustryname from lc_exgindustry as a join lc_sharestru as b on a.companycode = b.companycode order by nonlistedshares desc limit 5	ccks_stock	按未流通A股股数从大到小排序，排名前5的公司名称及所在一级行业
select count(distinct awardname) from mf_awards ;	ccks_fund	我们有多少种不同的奖项名称
select secretarybdtel from lc_stockarchives where chinameabbr='万科';	ccks_stock	您好，万科的董秘电话
select chinameabbr from lc_sharesfloatingschedule order by totalashares desc limit 10	ccks_stock	选取A股总股数排名前10的公司名称
select a.secucode, a.chinameabbr from lc_coconcept as a join lc_stockarchives as b on a.companycode = b.companycode where b.state ='安徽省' and a.conceptname ='无人驾驶';	ccks_stock	给王工提一下"安徽省""无人驾驶""板块的股票代码和名称
select count(*) from lc_mainoperincome where chinameabbr='中国石化' and mainoperincome > 200000000000 ;	ccks_stock	计算出中石化总共有几年的主营业务收入超过2000亿
select chiname, holdingpct from lc_relatedsh  where chinameabbr = '航天发展' and strftime('%Y', enddate)='2020' and strftime('%m', enddate )='3'	ccks_stock	2020年3月航天发展的股东及持股比例是多少
select secuabbr from mf_mainfinancialindexq  where strftime('%Y', enddate)='2020' group by  secuabbr having sum(totalprofit) > 1000000000	ccks_fund	2020年赚了10亿以上的基金
select  ratioceiling from ed_taxrate where typename ='中资大型银行' and itemname = '超额存款准备金率'  ;	ccks_macro	还有，看看"中资大型银行"的"超额存款准备金率"的最高比例
select astockcode,ashareabbr from lc_stockarchives where chinameabbr='科大讯飞';	ccks_stock	帮我找一下数据！科大讯飞的股票代码和证券简称
select a.secucode , b.secretarybd , b.officeaddr from lc_coconcept as a join lc_stockarchives as b on a.companycode = b.companycode where a.conceptname ='共享经济' ; 	ccks_stock	帮我找找数据，给咱找一下"共享经济"这个板块的股票代码有哪些，同时列出董秘名称和公司地址
select chinameabbr, playear, plaproceeds from lc_ashareplacement where plaproceeds < 100000000;	ccks_stock	展示一下数据，找出所有单次配售募集金额低于1亿的记录，罗列公司简称、配售年份、募集金额
select chinameabbr,regaddr from lc_stockarchives where city='银川市';	ccks_stock	我想了解一下数据情况。请问有银川上市公司和其注册地址信息吗？
select chinameabbr from lc_actualcontroller where controllername = '福建省财政厅';	ccks_stock	福建省财政厅实际控股了哪些上市公司
select nvdailygrowthrate from  mf_netvalueperformancehis ;	ccks_fund	帮我查一下基金的日回报率支
select a.secucode , b.state  from lc_coconcept as a join lc_stockarchives as b on a.companycode = b.companycode where a.conceptname ='元宇宙' ;	ccks_stock	"元宇宙"最近好火啊，帮忙看看这个板块的上市公司都是哪些省的，
select chinesename from mf_fmscaleanalysisn where equityfundnv > 100 and hybridfundnv > 50;	ccks_fund	哪些基金经理管理的股票型基金规模超过100亿，且混合型基金规模大于50亿
select chinameabbr from lc_financialexpense order by interestexpense desc limit 10	ccks_stock	利息支出排名前10的公司有哪些？
select reportperiod, indextype, indexvalue from ed_producerpiformp where  indexname ='冶金工业';	ccks_macro	快速找一下数据。那"冶金工业"的记录呢，请展示一下相关的统计周期和指数值，以及所属的指数类型
select secuabbr from mf_fundreturnrank where fundreturn > 0 and fundannreturn > 0	ccks_fund	帮我查一下，基金收益率和基金年化收益率均大于0的基金名称
select rrintwoyear from mf_netvalueperformancehis ;	ccks_fund	我想了解一下数据情况。查询一下各基金的两年回报率记录
select b.chinameabbr from lc_issueandlistagent as a join lc_stockarchives as b on a.companycode=b.companycode  where b.state='上海市' and a.underwritingvol>1000000;	ccks_stock	帮我找找数据，上海市上市公司股票发行承销数量大于1百万股的有哪些
select chinameabbr from lc_financialexpense order by commission desc	ccks_stock	按手续费降序排列的上市公司是哪些？
select chargeratedes from  mf_chargeratenew where secuabbr ='富国300ESGETF';	ccks_fund	"富国300ESGETF"的费率一般是多大 谢谢
select fpshname, involvedsum from lc_sharefp where secucode = '600180' and pctoftotalshares >=0.05 ;	ccks_stock	麻烦提供下600180的股权冻结数量占总股本比例达到0.05及以上的股东名称和涉及股数 感谢
select fullname from lc_issueandlistagent order by underwritingvol desc limit 100;	ccks_stock	找一下承销股数排名前100的承销机构
select chinameabbr from lc_freefloat where adjfreefloatratio = 100	ccks_stock	列出自由流通比例为100%的公司
select chinameabbr from lc_ashareplacement  where strftime('%Y', playear) = strftime('%Y', DATE('now', '-2 year'));	ccks_stock	帮我找找数据，前年有哪些公司配售股票了
select a.transferername, a.sumbeforetran, a.pctbeforetran from lc_sharetransfer as a join lc_stockarchives as b on a.companycode = b.companycode where b.state = '江苏省'	ccks_stock	帮我找找数据，罗列江苏省公司的股权出让方名称、出让前持股数量和出让前持股比例
select count(*) from lc_business where industryname like '%计算机%'	ccks_stock	我想了解一下计算机行业的上市公司有多少
select enddate, industrialoutputvalueap from ed_industryproduction where reportarea ='全国' and statstandard ='全部工业企业' and reportperiod ='期末累计';	ccks_macro	给王工查查一下"全国""全部工业企业"的"期末累计"工业总产值金额，记得带上时间
select chinameabbr from lc_mainoperincome  where strftime('%Y', enddate)='2021' order by  mainoperincome desc limit 5;  	ccks_stock	2021年主营业务收入从大到小排名前5的是哪几家公司
select secuabbr, name from mf_fundmanagernew order by performance desc limit 5	ccks_fund	帮我查一下这些数据。查找任职期间基金净值增长率排名前5的基金名称和基金经理名称
select unitnv, accumulatedunitnv from mf_netvalue where secuabbr = '国泰融信';	ccks_fund	嘿，列出基金产品国泰融信的单位净值和累计净值
select chinesename,totalfundnv from mf_fmscaleanalysisn order by totalfundnv desc limit 1;	ccks_fund	谁的总管理规模第一，市值是多少？
select b.secuabbr,b.manager from mf_bondportifoliodetail as a join mf_fundarchives as b on a.innercode=b.innercode order by a.marketvalue desc limit 1;	ccks_fund	您好，列出持有债券市值最高的基金和基金经理
select chinameabbr from lc_ashareseasonednewissue group by chinameabbr having count(*) > 1;	ccks_stock	siri, 请问哪些股票增发次数大于1
select rrsincethisyear from mf_netvalueperformancehis ;	ccks_fund	同学你好！列出各基金今年以来回报率记录
select bonusshareratio from lc_dividend where secucode ='000021';	ccks_stock	hello,000021送股比例是多少呀
select enddate ,imvalueofgoods , gyoyofimvaluegoods from ed_exportimport  where strftime('%Y', enddate) < strftime('%Y', DATE('now', '-10 year'));	ccks_macro	能提供下10年前，我国进口金额数据和进口同比增减的记录吗
select secuabbr,benchgrforsince from mf_benchmarkgrowthrate order by benchgrforsince limit 20;	ccks_fund	给出基金成立以来基准增长率最低的20个基金排名及增长率
select shname from lc_relatedsh  where secucode ='300184' and strftime('%Y', enddate) = strftime('%Y', DATE('now', '-1 year')) and round(strftime('%m',enddate)/3.0 + 0.495) = 4 ;	ccks_stock	去年第四季度300184的股东名称是什么
select leadername, shareamount from lc_executivesholdings where positiondescription like '%副总裁%'	ccks_stock	显示担任副总裁的高管姓名及期末持股数 谢谢啊
select bonusshareratio, divibase from lc_dividend  where chinameabbr ='西藏发展' and strftime('%Y', dividendimplementdate) = strftime('%Y', DATE('now', '-1 year')) ;	ccks_stock	我有一个需求，我想知道去年西藏发展的送股比例和分红股本基数
select domesticloans from ed_chinamoneyandbanking order by enddate desc limit 1;	ccks_macro	我们最近的一次登记的国内信贷金额是多大
select rrinsinglemonth from  mf_netvalueperformancehis ;	ccks_fund	嗨，能给我查一下各基金的一个月回报率记录吗
select  secucode, chinameabbr from lc_dividend  where actualcashdivirmb > 10 and strftime('%Y', dividendimplementdate) = strftime('%Y', DATE('now', '-2 year'));	ccks_stock	能帮我查一下前年实派金额超过10块的公司代码和股票名称吗
select rrsincestart, annualizedrrsincestart from mf_netvalueperformancehis ;	ccks_fund	我想了解一下数据情况。嗨，能个我取一下基金设立以来回报率和设立以来年化回报率吗
select leadername from lc_executivesholdings where chinameabbr = '石化油服' order by shareamount desc limit 1	ccks_stock	找一下石化油服期末持股数最多的高管姓名
select fpshname, accufpshares from lc_sharefpsta where secucode like '300%'	ccks_stock	哥，查出股票代码300开头的公司冻结质押股东名称及冻结质押股数
select secuabbr from mf_mainfinancialindexq  where strftime('%Y', enddate)='2020' group by  secuabbr order by sum(totalprofit) desc limit 1	ccks_fund	查一下2020年度总利润最大的基金
select rrinsingleyear, rrintwoyear, rrinthreeyear from mf_netvalueperformancehis where secuabbr = '易方达中小企业A';	ccks_fund	在线等！易方达中小企业A的一年、两年和三年回报率数据
select annualizedrrsincestart from mf_netvalueperformancehis ;	ccks_fund	请列出基金设立以来年化回报率的记录
select fundtypename, count(*) from mf_fundreturnrank where indexcycle = '一年' and fundreturn < 0 group by fundtypename	ccks_fund	显示指标周期为"一年"的基金收益率为负的基金数目，按基金类别分组展示
select rrinthreeyear, rrinfiveyear, rrintenyear, rrsincestart from mf_netvalueperformancehis ;	ccks_fund	请列出基金的三年收益率，五年收益率、十年收益率和设立以来收益率
select chinameabbr, totalshares from lc_sharestru where chinameabbr = '东北证券' or chinameabbr = '国元证券'	ccks_stock	显示东北证券和国元证券的总股本
select secuabbr from mf_fundarchives order by lowestsumsubll asc limit 1	ccks_fund	申购金额最低的基金是哪只
select a.chinameabbr, b.generalmanager, b.legalrepr from lc_dividend as a join lc_stockarchives as b on a.companycode = b.companycode  where strftime('%Y', a.dividendimplementdate)='2021';	ccks_stock	帮我查一下2021年分红的所有上市公司，以及他们的总经理和法人
select selfemployed from ed_retailvalueofscgoods ;	ccks_macro	我想知道我们个体单位这些年的社会消费品零售记录
select annualizedrrinfiveyear from mf_netvalueperformancehis ;	ccks_fund	嘿，帮我看一下基金的五年年化回报率数据吧 
select organizationform, count(*) from mf_investadvisoroutline group by organizationform order by count(*) desc;	ccks_fund	不同性质的基金公司分别有多少家，按照数量降序排列
select domesticloans , overseasloans , agriculturaldeposits from ed_chinafibalancesheetrmb  where strftime('%Y', enddate)<='2000' and totalloans >1000000;	ccks_macro	展示一下2000年以前，我国金融机构信贷收支记录中，各项贷款总额超过1百万时，境内贷款和境外贷款的记录 谢谢
select  profitdistributionrule from mf_fundarchives where secuabbr = '招商成长'	ccks_fund	帮我找一下数据！招商成长的收益分配方式
select count(*), secucode from lc_coconcept  group by secucode ;	ccks_stock	查一下每支股票所属的概念板块数量 谢谢啊
select annualizedrrinthreeyear , annualizedrrinfiveyear , annualizedrrintenyear from mf_netvalueperformancehis ;	ccks_fund	能搜一下基金的年化收益率吗，分别展示一下三年、五年和十年的
select b.secuabbr,b.investfield from mf_benchmarkgrowthrate as a join mf_fundarchives as b on a.innercode=b.innercode  where a.benchgrforthismonth<0;	ccks_fund	查出哪些基金的本月以来基金基准增长率为负及它们的投资范围
select mainname from lc_business lb where chinameabbr ='富临精工'	ccks_stock	列出富临精工的业务名称
select secuabbr from mf_fundarchives order by establishmentdate desc	ccks_fund	所有基金按设立日期从晚到早排 感谢
select  fpshname from lc_sharefp  where pctofpledger > 0.3 and strftime('%Y', enddate) > strftime('%Y', DATE('now', '-2 year'));	ccks_stock	这两年来，哪些投资者被冻结质押的股票比例超过了0.3
select secucode , nvweeklygrowthrate from  mf_netvalue ;	ccks_fund	我想了解一下数据情况。王工想知道咱们基金的单位基金净值周增长率，请查一下，记得带上基金代码
select proportiongrquarter from lc_shnumber  where strftime('%Y', enddate)='2020' and round(strftime('%m',enddate)/3.0 + 0.495)=2 and chinameabbr='京基智农';	ccks_stock	京基智农2020年2季度的户均持股比例季度增长率
select evalagent,signatureevaluator from lc_ipodeclaration where secucode='300278'; 	ccks_stock	300278的ipo评估机构和签字评估师
select retailvalueofscgoods from ed_retailvalueofscgoods where province ='江苏';	ccks_macro	贴一下有记录以来，所有的江苏省的社会消费品零售总额数据
select corporatesavings , financedeposits from ed_chinafibalancesheetrmb  where strftime('%Y', enddate)='2004';	ccks_macro	展示一下2004年，我国金融机构信贷收支中，单位存款和财政性存款分别是多少
select enddate from ed_financialbalance where province ='江苏' and localgovrevenue > 100 and localgovexpenditure < 100;	ccks_macro	江苏省哪些年地方财政收入大于1亿元，而地方性财政支出小于1亿
select industryname from lc_business where chinameabbr ='深科技'	ccks_stock	半导体板块最近比较火热，深科技涉足行业是什么，帮我确认下相关性
select mainoperincome from lc_mainoperincome  where chinameabbr ='中国石化' and strftime('%Y', enddate) = strftime('%Y', DATE('now', '-1 year')) and round(strftime('%m',enddate)/3.0 + 0.495) = 1;	ccks_stock	您好，中石化去年一季度的主营业务收入是多少亿
select secuabbr, indexcycle, fundreturn from mf_fundreturnrank where secuabbr = '华夏创蓝筹ETF' or secuabbr = '建信深证60ETF'	ccks_fund	能告诉我，华夏创蓝筹ETF和建信深证60ETF的指标周期和基金收益率分别是多少？
select totalfundnv from mf_fmscaleanalysisn where chinesename='张坤';	ccks_fund	有张坤旗下基金总管理规模的情况吗
select b.chinesename, b.totalfundnv, b.qdiinv from mf_personalinfo as a join mf_fmscaleanalysisn as b on a.personalcode = b.personalcode where a.nationality = '美国';	ccks_fund	哪些基金经理国籍为'美国'，并列出它们管理基金总规模，qdii基金总规模 谢谢
select controllername from lc_actualcontroller group by controllername order by count(*) desc limit 1;	ccks_stock	您好，我想知道哪些机构实控上市公司数量最多
select secucode from mf_fundarchives where secuabbr = '广发小盘A'	ccks_fund	广发小盘A的基金代码是多少 谢谢
select b.chinameabbr, a.secretarybd from lc_stockarchives as a join lc_freefloat as b on a.companycode = b.companycode where b.adjfreefloats > 10000000 and a.city = '深圳市'	ccks_stock	siri, 深圳市自由流通股本超过1000万的公司名称及董事会秘书
select claimtosavingsinst , claimtootherfinnonfininst from ed_moneyauthoritybs ;	ccks_macro	那在货币当局资产负债表中，对特定存款机构债权和对其他金融机构债券分别是多少也
select secuabbr from mf_keystockportfolio group by secuabbr order by sum(marketvalue) desc limit 1	ccks_fund	重仓股总市值最高的基金
select count(*) from lc_ipodeclaration where csrcindustryname='银行业';	ccks_stock	银行业有多少公司ipo？
select chinesename from mf_personalinfo order by birthdate asc limit 1	ccks_fund	请问哪个基金经理年纪最小
select a.chinameabbr from lc_intassetsdetail as a join  lc_stockarchives as b on a.companycode=b.companycode  where strftime('%Y', a.enddate)=strftime('%Y', DATE('now', '-1 year')) and b.state='浙江省' and totalrdinput>100000000;	ccks_stock	浙江省内去年有哪些公司的研发投入超过1亿元
select chinameabbr from lc_buyback  where strftime('%Y', advancedate) = strftime('%Y', DATE('now', '-1 year')) and (round(strftime('%m',advancedate)/3.0 + 0.495) = 3 or round(strftime('%m',advancedate)/3.0 + 0.495) = 4);	ccks_stock	去年第三季度和第四季度进行股份回购的公司有哪些
select b.chinameabbr, b.controllername from lc_stockarchives as a join lc_actualcontroller as b on a.companycode = b.companycode where a.state = '浙江省';	ccks_stock	浙江省所有上市公司简称及实控人 谢谢
select secuabbr,manager from mf_fundarchives where investadvisorname='国泰基金管理有限公司' and type='ETF';	ccks_fund	hello,找出国泰基金管理有限公司管理的所有ETF基金及基金经理
select count(*) from mf_benchmarkgrowthrate as a join mf_fundarchives as b on a.innercode=b.innercode where a.monthlybenchgr>0 and b.manager='朱少醒';	ccks_fund	朱少醒管理的基金一个月基金基准增长率为正的有多少
select indexvalue from ed_producerpiformp where reportperiod ='上年同期' and indextype ='工业结构分类指数' and indexname ='生活资料-食品';	ccks_macro	请简单查一下，我们"上年同期""工业结构分类指数"里，"生活资料-食品"的指数值
select mainoperincome , mainopercost, mainoperprofit from lc_mainoperincome  where strftime('%Y', enddate) = strftime('%Y', DATE('now', '-1 year')) and secucode ='000822';	ccks_stock	000822上一年的经营情况如何，展示主营业务收入、主营业务成本、主营业务利润
select closeprice from qt_dailyquote  where strftime('%Y', tradingday)='2021' and round(strftime('%m',tradingday)/3.0 + 0.495) = 1 and secucode = '300278';	ccks_stock	帮我查一下这些数据。2021年第一季度300278收盘价变动情况
select chinameabbr from lc_sharetransfer order by involvedsum desc limit 10	ccks_stock	siri, 选取涉及股数排名前10的公司
select a.firstindustryname from lc_exgindustry as a join lc_sharestru as b on a.companycode = b.companycode where b.nonlistedshares > 200000000 group by a.firstindustryname having count(*) > 50	ccks_stock	hello,请告诉我，哪个一级行业的未流通A股股数超过2亿的公司数目超过50家
select  fundcompany from  mf_awards  where strftime('%Y', `year`) >=2010 and awardname ='三年期股票型金基金奖' and winnertype ='投资基金';	ccks_fund	从2010年开始，"投资基金"中，有哪些基金公司管理的基金获得过"三年期股票型金基金奖"奖项
select name from mf_fundmanagernew where secucode like '15%' and performance > 0.7	ccks_fund	基金代码15开头的且任职期间基金净值增长率大于0.7的基金经理姓名
select enddate, totalassets, totalliabilities, foreignassets, foreignliabilities from ed_otherdepositorycorpbs where totalassets > 50000000 order by enddate desc limit 1;	ccks_macro	展示一下最近的一次其他存款性公司资产负债表中，总资产超过5000万的记录，列出时间总资产，总负债，国外净资产和国外负债的具体金额
select avgholdsumgrquarter from lc_shnumber where chinameabbr='古井贡酒';	ccks_stock	给出古井贡酒的户均持股数季度增长率信息 谢谢
select closeprice from qt_dailyquote  where strftime('%Y', tradingday)='2021' and strftime('%m', tradingday)='4' and chinameabbr = '华昌达';	ccks_stock	华昌达2021年5月股价变动情况
select fund, appraisalorg from mf_awards;	ccks_fund	嗨，能展示一下哪些基金获得过奖项吗，并列一下是谁颁发的
select ratiofloor from ed_taxrate where typename ='农村信用社' and itemname ='超额存款准备金率';	ccks_macro	你知道"农村信用社""超额存款准备金率"的最低比率吗
select b.chinameabbr, b.secondindustryname from lc_stockarchives as a join lc_exgindustry as b on a.companycode = b.companycode where a.state = '浙江省' and b.firstindustryname = '制造业';	ccks_stock	列出浙江省一级行业为"制造业"的公司名称及对应的二级行业 谢谢
select chinameabbr from lc_executivesholdings where leadername = '刘明强'	ccks_stock	找到名为"刘明强"高管的公司名称。
select b.secuabbr,b.investtarget from mf_benchmarkgrowthrate as a join mf_fundarchives as b on a.innercode=b.innercode  order by a.monthlybenchgr desc limit 10;	ccks_fund	找出一个月基金基准增长率排名前十的基金及投资目标
select leadername, chinameabbr from lc_executivesholdings where positiondescription like '%董事长%' and positiondescription like '%总裁%'	ccks_stock	帮我找找数据，找到同时担任"董事长"和"总裁"的高管姓名及所在公司
select secretarybd,secretarybdtel from lc_stockarchives where astockcode='600234';	ccks_stock	列一下600234的董秘和董秘电话信息
select collectiveunits from ed_retailvalueofscgoods ;	ccks_macro	siri, 那集体单位的社会消费品零售总金额是什么样的
select b.manager from mf_benchmarkgrowthrate as a join mf_fundarchives as b on a.innercode=b.innercode where a.dailybenchgr>0;	ccks_fund	哥，哪些基金经理的本日基金基准增长率大于0
select a.state , count(*)  from lc_stockarchives as a join lc_coconcept as b on a.companycode = b.companycode where b.conceptname ='石墨烯' group by a.state having count(*)>1;	ccks_stock	展示下"石墨烯"板块，上市公司数量大于1的省份有哪些，列出省份名称和具体数量
select a.firstindustryname, count(*) from lc_exgindustry as a join lc_freefloat as b on a.companycode = b.companycode where b.adjfreefloatratio = 100 group by a.firstindustryname	ccks_stock	自由流通比例为100%的公司有多少家，按一级行业分组统计
select a.chinameabbr, a.fpshname, a.accufpshares from lc_sharefpsta as a join lc_stockarchives as b on a.companycode = b.companycode where b.state = '河北省'	ccks_stock	查找河北省上市公司的公司简称、冻结质押股东名称、冻结质押股数
select imvalueofgoods, gyoyofimvaluegoods from ed_exportimport where gyoyofexvaluegoods > 0 and exvalueofgoods > 20 and strftime('%Y', enddate)<'2000';	ccks_macro	请查一下2000年以前，出口金额超过2000万，且出口同比增减量大于0的数据，列出进口金额和进口同比增长数据
select unitnv from mf_netvalue where secuabbr = '华安180ETF' and enddate >= '2021-4-1';	ccks_fund	看一下华安180ETF在2021年4月1日至今的单位净值数据
select education, experiencetime from mf_personalinfo where chinesename = '刘伟琳';	ccks_fund	帮我查一下基金经理刘伟琳的学历水平，从业年限
select chinesename from mf_personalinfo where experiencetime > 20 and gender = '女';	ccks_fund	帮我找一下从业年限超过20的女基金经理
select b.chinameabbr from lc_exgindustry as a join lc_sharestru as b on a.companycode = b.companycode where a.firstindustryname = '建筑业' and b.totalshares > 10000000000	ccks_stock	建筑业总股本超过100亿的公司有哪些？
select chinesename from mf_fmscaleanalysisn order by totalfundnv desc limit 1;	ccks_fund	现在谁管理的基金总规模最大 谢谢啊
select chinameabbr from lc_issueandlistagent where underwritingsum<100000000;	ccks_stock	哥，机构承销金额低于1亿元的公司
select retailvalueofscgoods from ed_retailvalueofscgoods where province ='天津' and reportperiod ='年度';	ccks_macro	请展示一下天津市历年来的社会消费品零售总额的"年度"统计数据
select indexvalue from ed_producerpiformp  where indexname ='饮料制造业' and reportperiod ='上年同期' and strftime('%Y', enddate) = strftime('%Y', DATE('now', '-1 year')) ;	ccks_macro	帮李工取一下上一年，"饮料制造业"的"上年同期"指数值
select chinesename,hybridfundn from mf_fmscaleanalysisn where chinesename='刘格菘' or chinesename='朱少醒';	ccks_fund	朱少醒和刘格菘管理的混合型基金数量分别是多少
select enddate, claimsonothernfinstitute, liabilitiestonfinst from ed_otherdepositorycorpbs  where strftime('%Y', enddate) = strftime('%Y', date());	ccks_macro	李工想知道今年，在其他存款性公司资产负债表中，对非金融机构债权和对非金融机构负债分别是多少，带上时间字段 谢谢啊
select secondindustryname from lc_exgindustry where firstindustryname = '制造业' group by secondindustryname order by count(*) desc limit 1	ccks_stock	我想了解一下数据情况。帮我查一下，一级行业为"制造业"，二级行业公司数量最多的行业名称
select count(*) from lc_legaldistribution ;	ccks_stock	帮我查一下这些数据。历史上有配售股票记录的公司有多少家
select count(*) from mf_netvalueperformancehis where rrsincestart > 1000;	ccks_fund	计算一下有多少只基金产品的累计回报率超过1000%
select indextype from ed_producerpiformp ;	ccks_macro	嗨，能显示一下我们工业品出厂价格指数表中，指数类型是哪些吗
select secuabbr from mf_netvalueperformancehis where secuabbr like '%稳健%' order by nvdailygrowthrate desc limit 1;	ccks_fund	名称中包含‘稳健’二字的基金产品中哪只日回报率最高 感谢
select b.secondindustryname, count(*) from lc_sharesfloatingschedule as a join lc_exgindustry as b on a.companycode = b.companycode where a.accumarketableashares > 5000 group by b.secondindustryname	ccks_stock	已流通股数超过5000万股的公司有多少家，按所属二级行业分组展示
select closeprice from qt_dailyquote  where strftime('%Y', tradingday)='2021' and strftime('%m', tradingday)='4' and secucode = '300278';	ccks_stock	2021年5月300278收盘价变动情况
select shname, holdingsum from lc_relatedsh where chinameabbr = '农发种业' and strftime('%Y', enddate)<'2019';	ccks_stock	帮我看一下2019年以前，农发种业有哪些股东，持股数量分别是多少
select playear, plaproceeds from lc_ashareplacement where secucode = '600859';	ccks_stock	600859在哪些年份配售过股份，募集资金分别是多少
select shname from lc_largeshsubscription where chinameabbr='博瑞传播' order by actualshares desc limit 3;	ccks_stock	列出博瑞传媒配股大股东里实配股数最多的三个
select secuabbr,benchgrforthisweek from mf_benchmarkgrowthrate where benchgrforthisweek<0 order by benchgrforthisweek asc;	ccks_fund	列出本周以来基金基准增长率为负的基金由低到高的排名，还有增长率分别是多少
select mainbusiness from lc_business where chinameabbr ='精研科技'	ccks_stock	列出精研科技的主营业务
select chinameabbr from lc_shnumber where proportiongrquarter>10;	ccks_stock	户均持股比例季度增长率超过10%的公司 谢谢啊
select chiname from lc_shnumber  where strftime('%Y', enddate)='2019' order by  shnum desc limit 5;	ccks_stock	你好，2019年股东户数排名前五的公司
select chinameabbr from lc_shnumber where avgholdsumgrhalfayear>20;	ccks_stock	列出哪些公司的户均持股数半年增长率超过20%
select claimstogov from ed_chinamoneyandbanking ;	ccks_macro	您好，我国货币与银行中，对政府债权有多少
select fpshname from lc_sharefp where chinameabbr = '瑞茂通' and pctoftotalshares > 0.05 ;	ccks_stock	查一下瑞茂通的股权冻结质押中，冻结数量占总股本比例超过0.05的股东名称
select savingsdeposits, agriculturaldeposits from ed_chinafibalancesheetrmb; 	ccks_macro	帮我找一下数据！列出金融机构信贷情况中，我国的储蓄存款和农业存款分别是多少
select imvalueofgoods, exvalueofgoods from ed_exportimport ;	ccks_macro	我们海关进出口记录中，历年的商品进口总额和出口总额分别是多少
select chinesename from mf_personalinfo where education = '博士'  order by experiencetime desc limit 1	ccks_fund	博士学历里证券从业时间最长的基金经理
select transferername, receivername from lc_sharetransfer  where chinameabbr = '宝钢股份' and strftime('%Y', trandate)='2018'	ccks_stock	找一下数据。查一下宝钢股份2018年的股权出让方名称和股权受让方名称
select capitalreceived, netabroadassets, domesticloans from ed_chinamoneyandbanking  where strftime('%Y', enddate) > strftime('%Y', DATE('now', '-2 year')) ;	ccks_macro	帮李老师查查，咱们最近两年的实收资本，国外净资产和国内信贷分别输多少
select investadvisorabbrname, regaddr, regcapital from mf_investadvisoroutline where regcapital > 10000000000;	ccks_fund	展示注册资本超过100亿的大基金公司及对应的注册地，注册资本 感谢
select transferername, sumaftertran, pctaftertran from lc_sharetransfer  where chinameabbr = '盛天网络' and strftime('%Y', trandate)='2018'	ccks_stock	列出2018年盛天网络的股权出让方名称、出让后持股数量和出让后持股比例
select fullname from lc_issueandlistagent;	ccks_stock	a股发行与上市聘请的中介机构信息
select grossprofit from lc_mainoperincome where chinameabbr ='西藏发展';	ccks_stock	哥，西藏发展还能继续持有吗，帮我查一下这些年西藏发展的毛利率
select imvalueofgoods, gyoyofimvaluegoods from ed_exportimport  where strftime('%Y', enddate) = strftime('%Y', DATE('now', '-2 year')) ;	ccks_macro	帮我找找数据，帮我查一下前年我国的商品进口金额和商品进口同比增减数据是多少
select chinesename from mf_personalinfo where nationality != '中国';	ccks_fund	找到所有非中国籍的基金经理
select claimsonotherfinstitute from ed_otherdepositorycorpbs ;	ccks_macro	展示一下数据，我想知道我们对其他金融机构债权的记录在其他存款性公司资产负债表是怎样的，请列出来
select closeprice from qt_dailyquote  where strftime('%Y', tradingday)='2021' and strftime('%m', tradingday)='1' and strftime('%d', tradingday)='14' and chinameabbr = '石基信息';	ccks_stock	帮我找一下数据！查一查石基信息2021年1月14日收盘时的价格
select issuepurpose from lc_ashareseasonednewissue where secucode = '300022';	ccks_stock	300022进行过股票增发吗？增发目的是什么 谢谢啊
select a.chinameabbr, a.fpshname, a.accufpshares from lc_sharefpsta as a join lc_stockarchives as b on a.companycode = b.companycode where b.state = '浙江省'	ccks_stock	显示所在省份为"浙江省"的公司，公司简称、冻结质押股东名称及冻结质押股数
select chinesename from mf_fmscaleanalysisn where numberoffunds>15;	ccks_fund	有旗下基金总数超过15个的基金经理吗
select hybridfundn, hybridfundnv from mf_fmscaleanalysisn where chinesename = '郑希';	ccks_fund	请问郑希有管理混合类型基金吗？数量是多少，规模又是多少
select dailybenchgr from mf_benchmarkgrowthrate where secuabbr='富国天丰';	ccks_fund	查询一下富国天丰的本日基金基准增长率
select region, count(*) from mf_investadvisoroutline where strftime('%Y', establishmentdate)>'2015' group by region;	ccks_fund	2015年以后，各地区成立基金公司数量分布
